あ	亜吾阿唖蛙亞嗚婀椏猗錏鐚閼啞上日生安会合在朱充当有芦我赤足宛或英空呼明海厚荒浅挙倦称畔浴逢庵麻粟開敢遇登揚愛雅飽綾彰遭網憧蕪編鮎厭讐會厦呀堊扛擧舉淺當痾翕蘆逅遘邂齏韲驤鴉
ああ	乎於吁咨噫憙猗
あい	合娃哀相挨逢愛鮎藍饗姶曖哇噫欸殪瞹藹阨靉鞋乃生会医和秋間綾優會埃隘
あいだ	間
あいて	対
あいの	藍
あえ	允饗和
あえもの	齏韲
あお	青碧靑仰蒼煽呷
あおい	葵
あおぎり	梧
あおぐろ	黝
あか	赤緋垢朱明厚紅赫淦絳
あかがね	銅
あかぎれ	皸皹胝
あかご	嬰
あかざ	莱藜
あかし	証験
あかつき	暁曉
あかな	茜
あかね	茜蒐
あから	赧
あかり	燈灯
あかる	耀
あが	吾何英昂崇
あがた	県
あがり	上東明揚
あき	尭紀秋瑛暁彰聡璃穐曉了日且旦白旭光朱亜亨空幸昌明昭信亮恭晃祥哲朗啓淳章清爽彬喜晶陽義嗣照誠詮楓飽察寧輝審徹諒叡憲燦瞭顕呆晄顯倬惘杲晤曄暸朖烱炳璋龝
あきぞら	旻
あきた	慊歉
あきな	商估賈
あきの	彰
あきら	了旭亨侃昂昌映昭亮玲哲朗啓章彪彬瑛晶智陽彰翠聡輝慧審融瞳曜鑑史旦現諒諦斌晟冏旻昶
あきらか	熙晢昿渙
あぎと	顎
あく	悪握渥唖鹸惡幄阨齷厄飽
あくた	芥
あくつ	圷
あくび	欠
あぐ	倦
あけ	明緋朱珠暁曙曉洙
あけぼの	曙
あげ	揚上挙擧
あげまき	丱
あこ	赤
あこが	憧
あこめ	衵袙
あご	顎腮頷顋齶
あさ	麻朝生旦旭浅漁淺苴
あさがお	蕣
あさひ	旭暾
あさり	蜊
あざ	字浅麻鮮淺痣
あざけ	嘲
あざな	字糾
あざむ	欺詑詒謾
あし	疋芦足脚葺葦蘆肢茨厚愛趺
あしかせ	桎
あしげ	騅
あした	旦
あしなえ	蹇
あしのうら	跖
あしぶえ	笳
あじ	味鯵蝋鰺
あじか	簣
あす	朱足飛遊
あず	阿預
あずき	荅
あずけ	預
あずさ	梓
あずま	東
あせ	汗焦
あぜ	畦畔畛
あそ	浅麻朝遊敖淺遨
あそびめ	娼
あぞう	薊
あた	仇与中辺応防熱與邊
あたい	価値價直估
あたえ	直
あたか	宛恰
あたた	温暖煦溫
あたたか	暄燠
あたま	頭顱
あたら	新
あたる	斉
あだ	仇讐徒冦婀綽讎
あち	遏閼
あっ	圧斡壓且安厚荒悪呆惡
あっぱれ	遖
あつ	圧充昌純睦斡徳壓軋遏閼宏厚淳得惇渥温貴敬集暑敦湊蒐鳩豊醇熱輯篤纂鍾亶攅腆豐輳暑溫
あつか	扱
あつかい	扱
あつし	享竺淳惇渥敦篤毅
あつまり	集
あつむ	伍
あつもの	羮
あつら	誂
あて	当宛當
あてら	左
あで	艶
あと	後痕跡蹟歩蹤阯步
あな	穴孔窟坎壙竅竇
あなが	強
あなぐら	窖
あなず	侮
あなど	侮狎謾侮
あに	兄豈
あによめ	嫂
あね	姉姐
あの	穴
あば	暴訐
あばら	肋
あひる	鴨鶩
あび	浴
あふ	溢
あぶ	虻危蛇煬
あぶみ	鐙
あぶら	油脂膏腴膩
あぶらあか	膩
あぶらな	薹
あぶり	焙
あま	尼奄冗天甘余雨海剰甜塰蜑餘
あまが	尼
あまざけ	醴
あまだれ	霤
あまつさ	剰
あまね	普遍洽
あまねし	弥普徇浹
あまの	天
あまり	余餘
あまる	余餘
あみ	畢網編罔罟罠
あめ	天雨飴穹
あめの	雨
あめりか	米
あも	天厦
あや	文礼郁恵琢彪理絢斐綾史危妖苑怪奇殆紋寄彩章順漢彰錦綺禮冉竒恠綵黻黼
あやか	肖
あやぎぬ	綵
あやつ	操
あやま	過誤謝謬愆繆跌
あゆ	鮎歩愛步
あら	灼非表荒洗粗疏新粕匪澣澡瑕蘯笨麁
あらい	洗
あらかじ	予
あらが	抗
あらがね	砿鉱丱礦
あらし	嵐
あらそ	争闘爭諍
あらた	改
あらたま	璞
あらと	砺
あらは	生
あららぎ	蘭
あられ	霰
あらわ	表現著顕著
あり	作蟻生在有社順
ありづか	垤
ある	有或歩儻步
あるじ	主
あれ	生荒
あわ	泡沫粟阿併怜哀淡慌憐勠怱恊恤粱倂
あわせ	袷
あわち	莱
あわび	蚫鰒
あわら	湶
あん	安按案庵暗鞍菴諳鮟黯行杏塩闇晏罨莇餡鹽
あんず	杏
い	井以伊夷衣亥位囲医李依委易威為畏胃莞倭尉惟異移萎猪偉椅葦意違維慰遺緯謂飴蔚鮪揖爲彙噫圍幃彝彜恚欹洟熨猗痿瞶矣肄苡詒貽逶醫饐鰊鰄入云五比去出生石氷印行合妃壱角忌言告谷良英往岩宜居炊函肥府門娃郁活指施食祖胆美風要院浩射逝凍埋容庵斎蛇唯堰善斑飯斐寝煎稜稲鋳衛磯癒已徠稻衞鑄倚凾壹帷徃怡懿檍渭炒熬痍齋縊譱膽菲藺蝟谿豬韋頤
いい	謂宜猪飯
いいつ	咐
いう	友
いえ	家宇門室廈
いえど	雖
いお	庵廬
いおの	庵
いおり	庵廬菴
いか	生怒厳嗔怎恚慍瞋
いかずち	雷
いかだ	筏槎
いかのぼり	凧
いかり	碇錨
いかる	鵤
いかるが	鵤
いかん	奈那
いかんせん	奈
いかんぞ	奈
いが	球歪毬啀
いがた	熔
いがり	碇
いき	生粋息域粹杙翊閾伯紀翌翼
いきお	勢
いきどお	憤
いぎりす	英
いく	生育郁粥幾囿墺毓澳燠礇鬻行至征城侑奧
いくさ	軍戦戰
いくさぶね	艟艨
いけ	池生活
いけにえ	犠
いけの	池
いげた	韓
いこ	鼓憩憇
いさ	功石威砂勇勲諌勳諫
いさお	功勲勣悳
いさか	諍
いさぎよ	屑潔
いさご	沙砂
いささ	些
いさむ	勲
いざ	射躄
いざな	誘
いざり	漁
いし	石
いしずえ	礎
いしだたみ	甃
いしづき	鐓
いしばし	矼
いしぶみ	碑碣
いしやま	岨
いじ	弄苛虐
いじく	弄
いじょう	牛
いず	出何和泉厳嚴
いずく	烏悪曷
いずくんぞ	渠
いずみ	泉湶
いずれ	孰
いせ	竜
いそ	磯汐急勤礒
いそが	忙惣
いた	板分至到格致惨戚悼痛詣傷潮廸怛悵炒臻
いたず	労
いたずら	徒
いただ	頂戴
いただき	頂顛戴
いたち	鼬
いため	撓
いたる	暢
いたわ	労
いだ	抱懐
いち	一市壱溢弌佚壹軼鎰鴪鷸逸
いちご	苺莓
いちじく	九
いちじる	著著
いちの	櫟檪
いちのく	九
いっ	一壱逸飯溢揖壹
いつ	一乙五逸溢稜弌佚噎軼鎰鴪鷸逸允伍壱斎慈壹曷齋
いつき	樹斎齋
いつく	愛慈厳嚴
いつくし	厳
いつつ	五
いつわ	偽詐僞佯譎
いづ	出泉厳嚴
いで	出
いと	糸絃絲愛線厭綸褸
いとぐち	緒
いとけな	稚
いとし	愛
いとな	営營
いとま	暇遑
いど	戸挑
いな	否員引苗辞稲稻
いなご	螽
いなだ	鰍
いなな	嘶
いにしえ	古往徃
いぬ	犬狗戌
いぬい	乾
いね	禾稲稻
いの	猪井伊亥祈祷飯悲稲稻祈
いのしし	猪猯豬
いのち	命
いはや	窟
いばら	楚荊茨
いばり	尿溺
いびき	鼾
いびつ	歪
いぶ	熏
いぶし	燻
いほり	庵
いぼ	疣肬
いま	今未
いまし	戒勅警飭
いまわ	忌
いまん	敏
いむ	忌
いも	芋妹薯藷蕷
いもうと	妹
いや	弥嫌厭否卑賎瘉卑
いやしく	苟
いよ	彌
いよいよ	弥愈逾
いよう	陽
いら	平苛郎
いらか	甍
いり	煎入西飯圦杁
いりえ	湾
いる	一入日
いるか	鯆
いれ	入
いれずみ	黥
いろ	色
いろど	彩
いろどり	采釆
いろり	炉鑪鈩
いわ	岩磐巌況祝矧巖况嵒祝
いわい	祝
いわお	磐巌巖
いわし	鰯鰮鰛
いわた	瀬
いわや	窟
いん	引印因咽姻胤音員院淫陰寅飲蔭隠韻堙婬恁飮殞氤茵蚓贇酳隕隱霪韵允伊囲均鷹什圍慇殷湮鸚
いんち	吋
いんの	因
う	右卯宇羽有迂佑雨於胡宥祐烏翁優鵜鴎于傴吁囿塢嫗桙燠瓮甌禹肬蓊謗鶲齲羽又牛区太尤友央生打布芋汚伐劫秀兎売防苑欧殴享受承府武海恩飢倦討浮娩埋悪産笛得郵雲植椎遊雄雅愚蒔銀熊綿稼餓撃熟請憂頭織濫饗菟韮膿凰賣鬱夘售孳惓抃拊搨擣擽盂紆茹賈餒饑擊產
うい	初茴外回黄
うえ	上飢植殖樹
うえじに	殍
うお	魚
うか	泛
うかが	伺窺諜覗俔覘遉
うかがい	伺
うが	穿
うき	浮
うきくさ	蘋
うきの	浮
うきぶくろ	鰾
うぐい	鯏
うぐいす	鴬鶯
うけ	受請
うけたまわ	承
うげ	向
うご	動揺蕩蘯蹌
うさぎ	兎菟卯兔
うさぎあみ	罘
うさぎう	兎
うさむ	茂
うし	牛丑後
うしお	汐潮
うしとら	艮
うしな	失喪
うしゃおし	孝
うしろ	後
うじ	氏蛆牛寺池路
うじゅう	従從
うす	臼碓涼薄漓磑
うすぎぬ	紗
うすぐ	腰
うすじ	筋
うず	渦水埋填
うずくま	踞蹲
うずたか	堆
うずまき	巴
うずら	鶉
うせい	浩
うそ	嘘鷽噓
うそぶ	嘯
うた	歌打吟唄唱転詠詩賦謡謠咏謌
うたい	謡謠
うたいめ	妓
うたが	疑
うたげ	宴讌
うち	内裡欝蔚熨內中打家討尉渕
うちかけ	袿褂裲
うちき	袿褂
うちぎ	袿
うちばり	梁
うっ	打討鬱
うった	訟訴愬
うつ	欝蔚鬱熨内写打抄空映尉移虚転遷謄摸冩寫徙
うつく	昌娃美佼倩妍姚
うつくし	旺美
うつつ	現
うつばり	梁
うつぼ	靭笂靱
うつろ	腔
うつわ	器器噐
うてな	台柎萼蕚
うで	腕
うでっぷ	腕
うでわ	釧
うと	疏疎踈
うな	項鰻唸髫魘
うなが	促
うなぎ	鰻
うなじ	項
うなず	頷
うなり	唸
うね	畝畦畔釆畆畴
うの	卯府鵜
うば	姥奪
うふ	大
うぶ	産產生幼
うべな	肯
うま	午馬甘巧旨美甜
うまい	生
うまかい	圉
うまは	生
うまや	厩駅廠厰廐
うまる	生る
うみ	海膿海臣溟瀛
うみょう	明
うむ	武
うめ	梅楳梅埋
うめい	命
うめん	麺
うや	谷
うやうや	恭
うやま	敬
うら	浦裡裏卜占末怨恨憾麗怏惆悵慍慊
うらかた	卦
うらし	嬉
うらな	卜占
うらない	卜占
うらみ	怨
うらや	羨
うり	瓜売賣
うりゅ	瓜
うりよね	糶
うる	生売砂漆潤蔚
うるい	閏
うるう	閏閠
うるお	沢渥湿潤濡沾洽霑
うるし	漆
うるち	粫粳
うるわ	彬麗斌
うれ	邑戚愁嬉憂騒恤悒
うれえる	桓
うれし	嬉
うろ	虚
うろこ	鱗
うわ	上浮
うわぐすり	釉
うわさ	噂
うわばみ	蠎蟒
うん	云運雲慍暈紜繧薀褞韵饂鶤均芸員温銀韻吽耘蘊溫
うー	烏武
え	永会江英画娃廻重柄悦恵瑛絵話餌慧叡衛荏洩頴蛙歪惠會囘哇噫徊攜椏淮繪茴踝迴錏鐚阨戸右央兄生由衣回吉亜囲図谷依押枝茂畏映栄計星美風挨笑得詠喜隈植飯愛雅携誉榎窪影潰壊懐獲唖穎畦罫亞榮衞壞柯穢鐫
えい	永曳泳英映栄営瑛詠影鋭叡衛嬰洩盈穎頴榮衞咏營塋曵楹殪潁瀛珱纓蠑裔贏郢霙銳央医延喜景慧暎睿翳
えいし	喜
えう	曜
ええ	詠鋭榮
えが	画描
えき	亦役易疫益液訳駅奕懌蜴蝪驛鯣益伯射浴掖繹腋
えくぼ	靨
えぐ	刔抉
えさ	餌
えだ	枝条條
えだち	徭
えち	噎抉粤蛻軋咽悦越説閲
えっ	越謁閲
えつ	悦越謁閲噎戉抉粤蛻鉞謁悅閱咽逸説
えにし	縁
えの	榎絵繪
えのき	榎
えばら	茨
えび	蝦蛭蛯老胡鰕
えびす	夷戎胡蛮戉羌貊
えびら	箙
えみ	蝦笑
えみし	夷
えやみ	瘟癘
えら	択偉豪撰選掏揀柬腮顋
えり	衿襟撰
えん	円奄延沿炎苑怨院宴堰援媛淵園煙猿遠鉛塩演鳶縁燕薗艶厭掩焔鴛圓偃冤圜娟嫣寃悁掾檐櫞淹渊湲烟焉爰篶簷綰艷莚蜒蜿讌轅鋺閼閻閹魘鹽黯黶緣宛咽垣員俺渉湾羨賢嚥婉捐椽衍涎臙袁豌焰
えんじゅ	槐
えんの	役
お	乃小夫央乎汚牡尾於勇烏朗悪雄緒穂苧惡唹塢淤靉緖乙下士大王圧弘史生包仰百老応呉臣折男忍邑阿押居治青卒府怖武房和哀音皇追負保勃面郎浦恩起鬼降桜扇帯島黄魚終推惜措淡捺畢麻隆越奥御堕渡落愛遠雅置億穏織帶奧穗櫻卆嗚擠殞穩耆訖趁隱飫郞黃
おい	笈甥纓及生老於追負姪
おいし	生
おいの	狼
おう	王凹央応邑往押旺欧殴皇翁紘桜逢黄奥幌横鴨襖姶鴬鴎晄凰奧應櫻嘔嚶墺嫗徃徨怏悒惶抂歐殃毆汪泱泓浤湟澳燠珱瓮甌秧篁簧罌蓊蝗謳遑鍠閘隍霙鰉鴦鶲黌黃橫大区太圧玉仰近宏尾芳相晃扇庵淡鷹媼懊枉袍鏖鞅鶯鸚鷗
おうぎ	扇
おうご	朸
おうし	特
おうじ	皇
おうち	樗楝
おうな	嫗
おお	大巾王太巨生仰多近庇邑奄欧果祁松青皇浩被唯衆帽蓋蒙碩蔽覆掩奧倬歐盍盖葢鉅
おおかみ	狼
おおがい	頁
おおがめ	鰲鼇
おおきみ	王
おおぎ	扇
おおご	朸
おおごと	瑟
おおざと	邑
おおし	繽
おおじ	逵
おおじか	麈
おおぞら	宙
おおだて	櫓
おおち	樗楝
おおづつ	熕
おおづな	紘
おおとり	鳳鴻鵬
おおむ	梗概
おおやけ	公
おおよそ	凡
おおん	御
おか	丘岳允犯阿岡阜侵冒峻陸傍嶽畧冐邱隴
おが	拝拜
おがみ	拝拜
おき	生沖居興起修奥順置奧澳燠
おきて	掟
おきな	翁
おぎ	荻脇蒹
おぎな	補
おぎゅ	荻
おく	沃屋奥億憶臆奧檍抑後送帰遅置贈皈貽遲餽饋贈
おくて	稚
おくび	噫
おくみ	袵
おくり	贈
おくりな	謚
おけ	桶岡置
おけら	朮
おこ	怒興煽
おこし	輿
おこた	怠嬾
おこっ	興
おこな	行
おこり	瘧
おご	僣敖
おごそ	荘厳嚴
おごる	汰
おさ	孟紀酋収圧伯抑乱押治長按修納統雄摂綜蔵厭收乂佰熨畧筬艾釐
おさえ	鎮
おさか	刑
おさな	幼孺
おさない	稚
おさむ	乃攻修理靖一紀順
おし	唖鴛忍押訓教慳敎
おしきうお	魴
おしどり	鴛
おしゃ	長
おしょ	忍
おじ	牡
おじか	麌
おじる	怯
おす	牡雄押
おそ	忙怖畏恐教遅襲兇兢怕恟悚惶惴慴懾獺瞿遲敎
おそれ	虞恐
おそれる	怯
おだ	穏煽穩
おち	乙戉榲粤膃鉞越落謁
おちい	陥陷
おちる	零
おっ	乙追越億
おっく	億
おっしゃ	仰
おっと	夫
おつ	乙榲膃越
おでる	稚
おと	乙音劣男弟
おとうと	弟
おとぎ	弟
おとこ	男郎漢
おとこだて	侠
おとこよもぎ	蔚
おとし	落
おとしい	陥陷
おとず	訪
おとめ	女
おとり	囮
おとろ	衰
おど	威脅踊嚇躍踴
おどし	縅
おどり	踊躍
おどろ	驚咢駭
おな	女同翁紳
おながざる	禺
おなもみ	葹
おに	鬼遠
おにやらい	儺
おの	斧斤自尾
おのおの	各
おのの	栗戦
おのれ	己
おば	姑姨
おひつじ	羝
おび	帯帶紳怯
おびただ	夥
おびだま	珮
おびと	首
おびや	劫脅刧
おぼ	没覚溺沒湎覺
おぼえ	覚覺
おぼろ	朧
おみ	臣
おも	主面沢思重惟想懐侖
おもい	思
おもかげ	俤
おもが	羇
おもがい	覊
おもて	表面
おもね	阿
おもねる	侫
おもむ	赴趣趨
おもむき	趣況况
おもむろ	徐
おもり	錘
おもんぱか	慮
おもんぱく	慮
おや	親生押
おやじ	爺
おゆ	生老
およ	及凡迄泳曁泅
およぎ	泳
および	及
おり	匂折織澱芳里
おる	処織
おれ	俺折
おれえるさま	忙
おろ	卸愚魯呆
おろか	痴
おろが	拝
おろし	卸颪
おろち	蠎蟒
おわ	坐終竣
おわり	終
おん	円苑怨音恩庵陰堰温御媛猿蔭薗穏厭鴛偃寃慍榲飮淹爰瘟穩菴薀蜿褞諳贇轅鋺鰮鰛溫牡宛垣鬼飲援雄暗園遠隠諺闇奧隱
おんな	女
か	下也化火日加可禾瓜仮何伽花里価佳果河苛茄彼和科架珂迦香耶夏家荷華蚊個菓貨袈渦過斯嫁暇禍嘩靴跨話榎嘉寡歌箇樺稼蝦課駕霞蘭卦蛤珈價个假咼啝囮堝夥夸廈彁找柯渮瑕笳舸萪蝸蝌裹訶謌譁譌谺賈跏踝遐顆禍一十川刈欠支壬且巨乎甲処代白圭交牡我克赤伯画庚郁枯狩神風変桂兼借書徒掛勘偽鹿掃鳥描梨猟賀葛換勝酢曾替貸買雅誇飼摂駆駈薫賭薙鍛鍋馨懸鰯鶴噛栢苅繋咋掻翔嗅乂凅呵咥嗄噬囓崋戈挂搗變槁歟痂窩缺罅胯舁艾虧訛軻鍜驅齟薰飼
かあ	母
かい	介亥会回灰快戒改芥貝画怪拐廻悔恢海界皆柏害桧晦械絵開階凱粥堺買解塊詮話魁概潰壊懐鎧蟹頴咳卦鮭楷諧壞懷乖价會傀囘剴咼垓夬乢屶嵬廨徊恠憇挂揩枴椢淮瑰畍盖瞶繪茴葢薤薈蠏褂觧詼豈迴邂醢隗鞋駭鱠悔海甘佳劾届垣桂掛街萱喫慨蓋該飼賄養骸憩轄鍵競穎珪罫掻櫂偕哇喙楫槐橈獪疥鬻膾蛔誨誡搔
かいが	鎌
かいこ	蚕蠶
かいと	泰
かいな	肱腕
かいばおけ	櫪
かいよね	糴
かいり	浬
かえ	換反却返帰替還卻歸皈
かえで	楓槭
かえり	省帰顧歸
かえる	蛙蟇
かお	顔顏香薫馨薰
かおり	馨薫芬
かおる	芳郁彪薫
かか	各拘抱係掲隠関繋嚊嬶關揭
かかあ	嚊嬶
かかと	踵
かかり	係掛
かが	利各屈香蚊鏡傴僂縢跼
かがみ	鏡鑑鑒
かがみたい	魴
かがみだい	魴
かがや	旺輝曜耀赫曄
かがり	篝
かき	垣柿堵蛎書塀墻牆硴蠣
かきの	垣柿
かきもの	帖
かぎ	勾鍵鈎限釣劃鉤鎰鑰
かく	各角画拡革客格核殻郭脚覚較隔塙閣確獲嚇穫劃廓撹赫掴卻咯埆壑斈寉幗愨擴桷梏椁殼狢瓠畫癨矍膈膕茖蠖覈覺謔貉钁霍骼鷽却岳秘碓隠潜蔵鶴嶽挌攪擱攫槨濳隱馘
かくし	隠隱
かくま	匿
かくれ	隠隱
かぐわ	郁馨
かけ	賭欠武掛懸缺
かけい	筧
かけはし	梯桟
かけば	齔
かけひ	筧
かける	走
かげ	陰蔭影掛景崗
かこ	囲託圏蓋喞圍栫
かこう	盖
かこつ	詫託寓
かご	駕輿篭籠筺轎
かさ	笠傘蓋嵩重套累畳襲暈疉瘡盖葢
かさか	笠
かささぎ	鵲
かさなる	疂
かさね	重累
かさねる	鄭疂
かざ	風桑飾賁餝
かざし	釵
かざり	飾錺
かし	樫橿呪柏械貸傾槝
かしこ	才畏賢俐
かしま	姦
かしら	孟頁魁頭仟顱
かしわ	柏膳栢槲
かじ	梶舵柁噛櫂囓楫橈
かじか	鰍悴鮖
かす	糟粕和春幽烏掠微霞
かすがい	鎹
かすみ	霞
かすみの	霞
かすめとる	抄
かすり	綛纃緕
かず	一毎壱寿宗和胤紀計員数憲數千凡万五収主邦利知昭葛量義收萬壽籌
かずのこ	鯑
かずみ	昭
かずら	葛鬘
かせ	校械笠稼枷綛
かせぎ	稼
かぜ	風
かぞ	数數
かた	片方形肩型剛容象潟賢議一才交固県堅硬犀酢尊淵傾塙語像竪鎌難舘牢縣劼鞏騙難
かたき	敵仇
かたく	頑
かたしろ	祢禰
かたじけな	忝
かたち	形象状貌頌皃軆
かたつむり	蝸
かたど	象模
かたどる	貌
かたな	刀釖
かたぬ	袒
かたば	酢
かたぶき	傾
かたぶく	傾
かたまり	塊団
かたみ	匪互筺
かたむ	傾昃
かため	瞎
かたよ	偏頗
かたわ	傍
かち	聒蛞豁濶括徒喝渇割葛勝筈渴
かちどき	凱
かっ	括喝勝滑褐刈甲各合角河画恰活格核渇脚割葛隔閣喀恪畫羯闊渴
かっぷ	冠
かつ	且功括活喝渇健捷曽割葛筈雄滑褐轄劼戛戞曷猾瞎磆聒蛞蠍豁濶鞨頡黠渴喝褐一巧克担鹿勝曾嘗刮尅戡擔甞蝎闊
かつお	鰹
かつみ	黄
かつら	桂葛蘰
かつり	和将
かづ	一和憲
かて	糧粮糅
かと	門
かど	圭角門稜才廉
かな	叶乎金門哀哉奏称悲楽鉄銀適敵恊縢鐵
かなえ	鼎
かなえざ	叶
かなまり	鋺
かなめ	紀要
かなら	必
かに	蟹蠏
かね	金矩懐錦鐘鉦鍾予包周兼鉄銀謙鎌釛鐵
かねが	鐘
かねぐら	帑
かねざし	矩
かの	叶彼鹿賀寒
かのう	叶
かのえ	庚
かのこ	麑
かのと	辛
かはる	陽
かば	椛蒲樺庇
かばね	姓
かばん	鞄
かび	黴
かぶ	株蕪冠被
かぶと	兜甲
かぶら	蕪鏑
かぶらや	鏑
かべ	壁
かほる	薫
かま	釜蒲窯鎌缶畑構竃冓竈窰釡鑵
かます	叺
かまど	竃
かまびす	喧嘩噌嗷聒諠譁讙
かまん	釜
かみ	上神紙髪髮神守侍皇督頭帋
かみかざ	珈幗
かみしも	裃
かみなり	雷
かむ	神
かむら	嘉
かむろ	禿
かめ	亀龜瓶瓷甌罌甁
かも	鴨甘神酎蒲樺醸醗釀鳧鳬
かもしか	羚
かもじ	髢
かもの	鴨
かもめ	鴎
かや	茅草萱茨柏栢榧茆
かゆ	粥癢鬻餬
かよ	通雅
かよい	通
かよわ	孅
から	空唐殻韓殼辛苛柄烏税絡漢樺涸縢
からか	揶誂
からかさ	傘
からくり	枢関
からし	芥辛
からす	烏
からたち	枳
からだ	体腔躯體軆
からなし	奈
からむし	苧紵
からめ	搦
からもも	杏
からんし	苧
かり	仮雁苅假刈香狩美借猟滑甸畋鳫
かりがね	雁鳫
かりずまい	寓
かる	苅刈剤軽緬輕
かれ	彼枯渠儂
かれい	鰔鰈
かろ	辛唐軽輕
かわ	川皮河革代逓渇乾楊晞渝熈躱渴
かわぐつ	鞨
かわごろも	裘
かわず	蛙
かわせみ	翠翆
かわや	厠廁溷
かわら	瓦甎甓磧磚
かわらげ	駱
かわるが	逓
かを	夫
かん	干刊甘甲汗缶完肝侃官函冠巻柑看竿莞陥乾勘患貫菅寒喚堪換敢棺款間閑湛勧寛幹感漢慣管関歓監緩憾還館環簡観韓艦鑑姦桓澗潅翰諌舘鹸卷陷丱凾刋勸啣圜坎坩奐嫺嫻寰悍慳懽戡扞拑捍揀旱杆柬橄樌欟歛歡淦渙湲澣瀚燗瞰稈篏繝罐罕羹羮莟蒄蚶觀讙豢轗邯酣銜鐶鑒鑵關頷顴駻驩骭鬟鰔鰥鸛鼾龕寬漢館丸幻広含串河限神康紺萱減蒲鎌苅翫廣咸喊奸宦嵌撼桿檻歉浣涵灌煥疳癇皖箝緘艱諫鉗鹹神
かんが	考稽鑑鑒
かんがみ	監
かんざし	簪釵
かんぞう	萱
かんど	梶
かんなぎ	覡
かんぬき	関閂
かんの	甲
かんば	樺芳
かんむり	弁冠冕
が	牙瓦疋伽我画芽俄臥峨賀雅餓駕蛾呀哦囮娥峩畫莪譌鵝下子日仮合何果河苛珂狩家荷華蚊菓掛偽鹿閑禍鈴嘉歌箇鍬蟹罫假衙鵞
がい	外亥貝劾害崖涯凱街慨蓋該概骸鎧咳碍苅呆乂剴啀垓崕嵬皚盖睚磑艾葢豈隗駭鮠慨槪刈会谷海界垣階買飼丐會孩愾漑礙
がえ	肯枝替
がえる	蛙
がお	顔
がおか	丘
がかり	係掛
がき	垣柿城書描
がぎ	垣
がく	学岳楽額顎鍔鰐樂壑學斈寉嶽愕狢瘧萼蕚貉鄂醵鶚鷽齶角逆覚鶴咢覺諤
がくし	隠隱
がけ	崖掛垳崕
がさ	傘笠嵩
がし	貸樫
がしら	頭
がしわ	柏
がす	粕
がすみ	霞
がすり	絣
がせ	瀬瀨
がた	片方形肩型県堅髪潟縣
がたき	敵
がたけ	岳嶽
がたな	刀
がたみ	筐
がたり	語
がだき	滝瀧
がち	月曷鞨活褐
がっ	合月学勝楽顎樂學
がつ	月刈勝
がつお	鰹
がに	蟹
がね	金兼鉄鐘鐵
がの	我鹿
がのう	我
がはな	鼻
がま	釜蒲窯鎌竃竈
がまち	框
がみ	紙上尻耳神髪頭髮
がみね	峰峯
がめ	亀瓶甕甁
がも	鴨蒲
がや	谷萱
がゆ	粥
がら	柄殻殼十辛潟
がらき	楽樂
がらし	嵐
がらす	烏
がり	刈狩借苅
がる	軽輕
がわ	川側皮河革
がわら	瓦
がん	丸元完含岸玩岩眼強寒換雁頑源韓顔願巌桓翰癌翫贋巖偐啣嵒愿懽扞捍旱澣瀚狠碪芫莟邯酣銜頷顏駻鳫鼾龕汗河官原貫漢緩厳鑑嚴嵌鴈
き	己木生企伎危机気岐希忌汽玖奇祈季祁其林紀軌祇既帰記起飢鬼桔黄基寄規亀崎葵喜幾揮期棋稀貴智棄旗箕器嬉毅畿輝槻窺機磯徽騎妓碕氣毀綺熙麒亟冀几剞匱咥唏喟噐圻竒弃悸愧憙掎揆晞曁曦朞枳棊榿欷歸沂熈燬燹皈瞶祺禧稘簣籏羇耆虧覊覬譏豈跂餽饋饑龜祈黃器旣刃公水切可甲示北衣吉次虫肌伐妃亜技決材来利杵効枝明茂峡哉城矩消訊姫埼斬欺極善堕着碁置嘉聞戯敷舗樹犠聴鎮蛎亞來峽暉藝聽僖决刄刋卉夬屓斫杞槎麾淇煕熹畸癸羈聆蠣詭諱跪逵鐫鑚馗騏驥
きい	紀基給
きき	聞
ききい	可
ききめ	効
きく	掬菊鞠麹椈鞫畜蓄
きくいむし	蠹蠧
きくす	掬
きこ	樵
きこり	樵蕘
きさ	象兆私蚶
きさき	后妃
きささげ	楸
きざ	兆刻萌萠剞雕
きざし	萌
きざはし	陛階
きし	岸崖汀垠墺軋
きしの	岸
きじ	樸雉
きす	鱚
きず	傷創築瑕疵
きずな	紲緤縻
きそ	競竸
きた	北来阿鍛來釟
きたな	汚
きち	吉詰橘
きっ	喫橘拮切生吉桔亀菊吃
きつ	吉迄喫詰橘吃佶訖頡乞生屹
きつね	狐
きな	黄黃
きぬ	絹衣繭
きぬた	砧碪
きね	杵
きの	紀木城
きのえ	甲
きのこ	茸蕈
きのと	乙
きはだ	檗蘗
きば	牙
きび	黍苛厳嚴峭禝
きびす	踵
きほ	穂穗
きみ	公仁君卿王紀皇
きも	肝胆
きゃ	伽茄迦可花華脚
きゃが	可
きゃく	却客格脚戟隙激赫掴卻咯幗矍膈膕茖謔郤醵钁闃骼鬩鴃鵙革喫撃嚇
きゃっ	却客脚
きゃん	侠
きゅ	久究喜
きゅう	九久及弓丘旧臼休吸朽求汲灸究玖泣急級糾柾宮笈亀救球給鳩厩窮仇韮穹嗅岌廐廏恷摎樛歙烋疚皀繆翕舊苙蚯裘貅逑邱鬮臭僑柩糺躬
きゅうら	厳嚴
きょ	去巨居拒拠挙虚許距鋸嘘渠墟據擧舉歔踞遽醵虛圭車据景裾倨
きょう	凶叶共匡叫交向杏亨狂劫享京供協況岬恰峡挟狭県亮恐恭胸脅校強教郷経梗卿喬敬軽境蕎橋興矯鏡馨競響饗驚袷撹橿侠僑兇彊怯荊佼鮫峽狹曉驍亰兢竸冏况刧剄呷哽夐姜嬌峺徼恟恊慊抂挾摎洶澆烱烋畊皀皎礦磬磽秬窖竅筺筴篋經繦羌羮薑蛩蛬襁誑轎逕鏗鞏餃鵁俠響敎鄕兄巧甲坑孝更押径庚郊香耕脇頃覚暁景絞較傾酵慶警頚砿韮頬僵匈嚮夾梟疆矜莢跫鋏陜竟驕
きょく	旭曲局極亟勗洫蕀跼玉棘
きょっ	旭曲極
きよ	圭洗淳聖廉精澄匡青香浄恭斎清雪貴誠輝潔瀞淨洌瀏皎淸
きよし	圭忠淳晴靖潔清渙
きよん	慶
きら	水明現嫌燦
きらめ	燦
きり	切桐錐霧斬
きりぎりす	蛬
きりみ	臠
きりゅ	桐霧
きる	吉
きれ	巾裂
きろぐらむ	瓩
きろめーとる	粁
きろりっとる	竏
きわ	際究谷極窮倪
きわだ	檗蘗
きわめ	極
きん	巾斤今均芹近欣金衿亀菌勤欽琴筋軽僅禁禽緊錦謹檎襟亰噤忻憖掀擒槿窘箘覲鈞釿麕黔勤謹公京訓経堅菫瑾衾釁饉
ぎ	刀木伎技宜祁祇城偽葵欺義疑毅儀戯誼擬犠議蛾妓蟻碕鰭僞戲匱竒嶬嶷巍揆曦棊沂犧祺簣籏耆萓跂餽饋示衣危机気吉岐汽来奇祈杵枝其紀宣起黄規埼喜棋貴極着裂碁置旗器樹親騎葱來氣几祗羲艤逵魏黃
ぎく	鞠菊
ぎし	岸
ぎた	北
ぎち	佶
ぎっ	牛切
ぎつね	狐
ぎぬ	衣被絹
ぎみ	君
ぎめ	極
ぎも	肝
ぎゃ	伽茄脚
ぎゃく	虐逆屐瘧覈覡謔鷁劇額
ぎゃっ	逆
ぎゅ	牛
ぎゅう	牛岌久生
ぎょ	魚御漁語禦圄圉齬馭
ぎょう	叶仰行杏形尭肴喬暁業蕎橋凝噛侠僑堯曉驍傚竸勍匣嶢徼恊檠澆烱煢狎禺轎迥餃黥刑迎京協茎効幸峡挟狭型桁倖校教蛍硬衡鯨競頚僥洽翹蟯
ぎょく	玉嶷曲獄
ぎら	明
ぎり	桐切限霧
ぎれ	切布
ぎろ	宏
ぎわ	極際
ぎん	吟銀圻垠崟憖沂狠釿巾金懃齦
く	九弓口工凶区公勾旧句古休灸玖苦股虎胸矩袴跨鳩厩駆駈鈎倶狗躯姑菰鈷垢叩韮釦穹估佝冓冦凅劬區吁媾嶇廐廏怐恷恟扣挧搆摎枸柧桍椌洶煦疚痼瞿瞽窶箍箜罟胯苟乕蚣蚯蛄蛬衢觚詬貅賈遘邱鞏驅鬮鴣皷齲久孔仁六右丘功朽共汲究呉攻来育奇供具空呼固拘杭国悔逆孤故枯紅臭食家核鬼宮恐恭庫貢酌亀救球授組雲喰雇裂鼓溝腫飽構腐暮戯駒購繰顧咋篭來國籠吼啗嗇竒懴懼柞蒻袱餔悔軀
くい	杭喰咋灰食杙
くう	弓凶空腔兇倥鞏孔共劫供宮控
くが	救陸
くき	茎莖洞柊岫
くぎ	釘
くく	括
くぐ	潜濳
くぐい	鵠
くぐり	潜潛
くぐりど	閤
くげ	鵠
くさ	草日臭種腐苡臭
くさか	草
くさぎ	耨
くさび	轄
くさぶき	茨
くさみ	嚔嚏
くさむら	叢
くさめ	嚔嚏
くさり	鎖鏈
くし	串釧櫛箆奇筆
くしけず	櫛
くしげ	匳奩
くしざ	串
くしゃみ	嚔嚏
くしろ	釧
くじ	挫櫛抉籤籖鬮
くじら	鯨
くす	楠樟葛薬藥熏
くすぐ	擽
くすし	医
くすの	楠
くすのき	梢楠
くすり	薬藥
くず	屑葛楠崩堕樟
くずれ	崩
くせ	癖曲
くそ	糞
くだ	管下砕降碎摧
くだり	行
くだん	件
くち	口啄朽屈
くちさき	吻
くちなし	梔
くちなわ	蛇
くちひげ	髭
くちびる	唇脣
くちわき	吻
くっ	屈掘倶
くつ	屈沓忽掘窟靴倔崛朽堀鞋
くつがえ	覆
くつした	襪
くつの	沓
くつろ	寛
くつわ	轡啣銜
くて	湫
くどくど	諄
くに	邑国郁訓晋薫國一州邦洲城柴郷都圀薰
くにつかみ	祇
くぬ	功椚
くぬぎ	橡椢椚椡櫪欅
くの	九此
くば	配
くび	首頚項頸
くびき	剄
くびす	跟踵
くぼ	凹窪
くま	阿隈熊曲汲奧嵎暈澳
くまの	熊
くみ	伍組与汲訓酌腫
くみあい	社
くむら	久
くめ	粂
くも	雲蜘曇
くや	悔悔
くゆ	熏
くら	倉椋鞍蔵藏比車沌昏昧庫座冥晦暗較夢蒙闇咋餐儚竸啗峅廩杳暝溟眛瞹矇罔黯
くらい	位蔑
くらし	蔵
くらの	蔵藏
くらん	蔵
くり	栗作来繰來刳
くりや	厨庖廚
くりゅ	栗
くる	包狂来苦胡栗來猖
くるう	狂
くるお	狂
くるぶし	踝
くるま	車俥輅
くるみ	生楜
くるり	転
くるわ	郭廓郛
くれ	昏莫呉暮榑
くれない	紅
くろ	黒黑玄畔患緇黔
くろう	蔵
くろがね	鉄銕鐡
くろきび	秬
くろごめ	糲
くろだけ	篶
くろま	車
くわ	桑鍬鋤加詳精錆咥啣耨
くわだ	企
くわの	桑
くん	君訓勲薫勳桾熏燻皸皹羣裙醺麕薰江軍郡群葷
くんね	薫薰
くー	姑
ぐ	牛弘臼求吾具胡球梧寓遇隅愚虞仇倶狗狐惧劬唔寤嵎忤晤滬牾珸瓠瞿禺窶篌藕蛩蜈衢裘逅逑扈餬麌齬久戸木旧共后玖呉居供苦後侯厚洪紅虹郡娯悟候貢骨偶湖雇喉群誤窮醐鴻壷颶
ぐい	杭越
ぐう	功宮偶寓遇隅嵎禺藕蛩窮
ぐき	茎莖
ぐけ	絎
ぐさ	枝臭草種
ぐし	串櫛
ぐしく	城
ぐす	楠
ぐすく	城
ぐすり	薬藥
ぐせ	癖
ぐち	口
ぐつ	靴忽葛
ぐつわ	轡
ぐに	国國
ぐま	隈熊
ぐみ	組汲
ぐも	雲
ぐもり	曇
ぐら	掠倉鞍蔵藏
ぐらい	位
ぐらし	暮
ぐらむ	瓦
ぐり	栗群
ぐるま	車
ぐれ	博暮榑
ぐろ	畔黒黑
ぐわ	桑
ぐん	軍郡群羣裙麕
け	化毛加瓜会気圭芥茄迦恢契家桧袈啓渓開稀堺跨榎嘉魁駕咳卦繋罫笥珈氣价傀咼唏夬夸廨恠挂揩晞曁枅枴椢欷瑰畍皈笳笄胯蝸袿褂觧詼譏谺豈賈跏醯饑髻鱠介右生付仮灰危虫花快戒希汽価佳怪祁届附架悔界皆計華既帰恵消異晦掛掲葵階街幾揮喫検嫁解塊靴継誇賄寡稼輝戯慶稽機磯徽鶏蹴懸鮭檢鷄假懈癸銷
けい	兄刑圭形系佳京径茎係型契計恵桂啓掲渓経蛍卿敬景軽傾携継詣慶慧稽憩鏡警鶏馨競珪畦繋罫荊頚鮭惠憬鷄亰偈竸冏剄勍夐奚徑恚憇挂攜枅檠溪烱煢盻磬禊笄經繼莖螢袿蹊輕迥逕醯頸髻黥揭家頃境肇鯨驚勁奎兮哇炯瑩瓊痙硅絅綮脛謦谿閨繫
けが	汚涜溷褻黷
けき	戟隙激屐覡郤闃鬩鴃鵙喫劇撃
けさ	畩
けし	岸消
けしか	嗾
けじめ	数
けす	簀
けず	削剤創刋刪
けた	桁
けだ	蓋盖葢
けだもの	獣
けち	血訣决刔劼孑戛戞抉挈瞎訐譎頡髻鴃欠決契桔結潔
けっ	欠血決結傑缺穴潔蹶
けつ	欠穴血決頁桔訣結傑潔蕨偈决刔厥囓孑抉挈杰桀獗碣竭缺蠍襭覈訐譎頡髻契渇掘掲楔歇纈闕
けな	穴健
けにえ	贄
けぬき	鑷
けば	毳
けみ	閲
けむ	煙烟
けむり	煙烟
けもの	獣獸
けやき	槻
けら	螻
けり	鳧鳬
けわ	陀峨峻険巌險巖峩峭嵒嶇嶢隗
けん	犬件見券肩建研県倹倦兼剣拳軒乾健捲牽険絃舷菅絢萱間喧圏堅検硯嫌献絹遣権憲賢謙鍵顕験繭懸鰹姦澗諌鹸圈儉劍縣險檢顯驗丱俔劒劵呟夐妍娟幵惓愆慊慳拑掀揀搴暄柬椦權歉涓狷獻甄痃筧篏綣繝羂腱臉蒹諠謇讙蹇鉉鑒顴鰔鰥鵑黔硏鹼欠玄串弦巻宣現減勧慣関監鎌簡鑑卷劔剱嶮眷虔譴釼騫
げ	下毛外疋嘩解詣樺霞咳碍苅繋乂倪偈兮剴呀啀囈圻奚崕嵬廈廨找沂瑕盻睚睨禊艾薤蠏觧譁貎遐邂隗霓鞋駭鮠鯢麑化牙刈元瓦母気向花系芸児芽拐祈祁悔係削柳夏家華械崖涯袈間卿殖暇雅蝦毅畿戯慶骸蟹蹴鮭笥氣戲藝崗礙餉
げい	芸迎詣鯨藝倪囈睨磑貎霓鯢麑黥児慶稽鶏猊
げき	戟隙劇撃激屐覡郤闃鬩鴃鵙鷁擊逆檄
げた	桁
げち	頁偈囓杰桀蘖猾碣磆竭襭覈霓黠穴吉渇掲滑傑轄
げっ	月撃激齧擊
げつ	月囓孑蘖霓頡鴃
げを	雄
げん	元幻玄見言弦県限彦莞倦拳原乾捲現絃舷這雁硯減源諺厳巌嚴巖俔偐啣圜妍嫺嫻寰嵒惓愿拑湲狠痃芫豢鉉銜鐶顏顴骭鬟鳫黔件岩研陥倹軒患眼間閑喧頑嫌監還賢環顔験願懸艦癌贋驗眩衒訝阮硏
こ	己子小火戸去乎古仔冴拠呼固股虎昆孤弧故枯胡起個庫粉袴湖雇誇跨鼓瑚糊鋸醐護顧嘘妓姑狐菰鈷壷琥錮个亟估冱凅夸據舉朞柧桍楜歔沍滬滸瓠痼瞽禧箍罟葫乕蛄觚賈踞扈餬鴣皷戶久巾乞口巳互匂木巨弘甲込史正代宇此州孝児車来河居苦幸国肥放紀香美彦家記挙桑高蚕姫娘恋黄基虚許康混据越喜期欺焦超雄裾箇漕戯請凝樹濃懲垢漉篭來兒國籠呱哥怙戀抉沽罩胯腴蝴蠱蠶詁踰辜逾虛黃懲
こい	恋鯉戀肥醇濃
こいねが	冀
こう	口工公勾孔匂功巧広弘甲匡交光向后好江考行亙亘杏汲亨坑孝宏抗攻更劫岡空効幸庚拘昂杭肯肴恰後侯厚巷恒洪皇紅荒郊香候倖晃校浩紘耕航貢降高黄教康控梗皐喉慌港硬絞腔項斯溝鉱幌構綱膏酵閤稿興衡鋼縞講購鴻壕藁轟饗袷鈎撹橿噛彊怯狗佼垢糠肱砿濠鮫叩蛤釦昊恆晄廣亢伉佝倥傚冓冦况刧匣吭呷哈哽哮啌堽壙姜媾嫦峇峺徨怐惶扣扛搆摎效杲晧昿杠枸椌槁槓槹歙洽浤湟溘烋熕犒狎畊皀皋皎盍盖矼礦磽稾窖筺筴箜篁篌簧絋絳絖繦纐缸羌羔羮翕肛胱膠苟葢蒿薑蚣蝗襁詬誑誥軣逅遑遘鍠鏗鑛閘閧闔隍靠頏餃鰉鱇鵁鴿黌黃姤上日句号尻正吸仰合而迎告押河泣享況茎岬革急級峡狭拷首神虹祐格脅桁剛耗脇兜郷絃覚給蓋較誠豪横衝穂鴨顔響梱洸凰皓滉煌穗僵咬哄嚆寇崗恍慷拱攪攷敲曠汞淆狡猴甦睾耿肓胛薨蛟覯訌神
こうがい	莱笄
こうじ	麹糀麴
こうせ	正
こうぞ	楮
こうの	鴻
こうのとり	鸛
こうぶり	冠
こうべ	頭首
こうむ	被蒙
こうもり	蝙
こうり	梱
こえ	声肥聲越咾
こお	弘浩公孝冴幸香郡耕凍冱冰凅
こおり	氷郡凍群織冰
こおろぎ	蛩
こがらし	凩
こぎ	漕
こく	克告谷或刻国黒惑穀酷鵠國亟勗尅愨梏槲洫蕀轂釛黑穀吿石旭曲殻剋哭斛
こくび	袵
こけ	苔鱗
こけら	苔鱗
こげ	芝焦
ここ	此云斯爰茲
ここに	粤
ここの	九
ここらざ	志
こころ	心試嘗
こころざ	志
こころざし	志
こころよ	快
こご	凍凝跼
こし	腰輿吉越漉濾沪
こしかけ	榻
こしが	越
こしき	甑轂
こしら	拵
こす	宇越擦
こず	梢
こずえ	梶梢槙杪
こそ	社
こぞ	挙
こた	応対堪答應荅
こだま	谺魎
こだわ	拘
こち	迄忽骨惚蕨厥榾獗蠍訖訐鶻乞堀滑窟吃鯒
こっ	骨乞木克刻国黒滑酷國黑
こつ	忽骨惚滑兀榾笏鶻乞堀越窟
こて	犢鏝鐺
こと	允功言事紀殊異琴珠亊縡
ことごと	悉尽畢
ことごとく	侭
ことづ	託
ことに	特
ことば	詞
ことぶ	寿
ことぶき	寿壽
ことほ	寿
ことわ	断斷
ことわざ	諺
ことわり	理
こども	竪
こな	粉熟
こなもち	麭
この	斯木好此近這憙
このしろ	鮗
このみ	慾
こはぜ	鞐
こはだ	樸
こば	拒
こばこ	筺
こばち	碗
こひつじ	羔
こび	媚
こぶ	瘤
こぶし	拳
こぼ	溢零
こま	駒狛困細綿齣
こまん	駒
こみ	込君
こみち	径逕
こむ	劒
こめ	米
こめぐら	禀
こも	菰薦篭
こもの	厮廝
こもり	篭籠
こよみ	暦曆
こら	堪怺
こり	梱織
これ	之惟斯祁是唯維寔
ころ	比頃夷死挙殺転湖劉轉擧轆殺
ころぎ	蛬
ころも	衣頃衲
こわ	声怖恐強壊壞聲
こわし	毅
こん	今困欣金昏昆衿恨根婚混痕紺萱欽喧港魂錦墾懇坤梱艮渾劵坎壼忻悃戡掀暄棔槿淦溷滾狠琿箘綣菎袞諠諢讙跟蹇轗釿鯀鯤鰔鶤麕龕巾斤欠近券建剣軒亀堪筋圏勧感禁献権憲謹襟藍崑很棍權焜獻褌釁
ご	牛五互午乎古伍呉吾冴胡後娯悟魚梧御瑚碁語誤糊醐檎護渠禦狐冱唔圄圉寤忤晤棊沍滬牾珸秬篌葫蜈扈醵餬麌齬吳娛子小戸右巨込后忌児河居拒固其弧砂庫剛蚕郷越期棋距湖虞漁豪興擬塵壷篭兒籠茣鄕
ごい	鯉恋戀
ごう	号合劫昂拷笈剛強郷項業豪壕轟噛彊濠昊傲刧匣吭哈嗷嫦岌抂敖晧洽熬盍盖缸苙葢藕號螯軣遨閧闔頏鰲鼇鄕及巧仰后江行狂迎抗河杭巷恒神桁浩航降峯偶硬蓋興囂毫盒
ごうり	群
ごえ	声肥越聲
ごおり	氷郡
ごく	極獄鵠嶷槲跼釛玉石局国國圀嶽
ごけ	苔
ごころ	心
ごし	越腰漉
ごせ	生越
ごち	月倔兀崛碣竭鶻屈掘堀
ごっ	極
ごつ	兀
ごと	如毎言事琴每
ごの	河
ごま	駒
ごみ	芥塵込埖
ごめ	篭込米
ごや	越
ごよみ	暦曆
ごり	鮴
ごろ	来挙殺頃來擧
ごろも	衣
ごわ	強
ごん	元言欣混痕僅禽源憾鍵檎艮凾噤圻垠崟愿擒沂溷狠琿碪窘箘芫莟覲諢釿頷黔含芹近吟金函恨原菌健勤琴圏銀魂権厳願嚴儼很權蒟勤
ごんにゃ	蒟
さ	叉左佐沙坐作些査砂茶唆差挫紗詐嵯裟蓑瑳鎖咋乍狹做嗄嵳扠搓柤梭槎灑簔縒莎蹉釵鮓鯊十下才三山小去皿生再早任帆決冴坂沢里冷幸刺舎知注架狭咲指浅座桜桟射酒挿教彩菜蛇捺覚割寒粧然提裂猿毅醒避謝櫻决冱剳嗟寤拆擘棧淺渣澤瑣磋箚螫覺鷦揷
さい	才再西災妻采哉砕洗宰栽晒柴凄栖彩採済砦祭斎細菜偲最犀裁棲債催塞歳載蓑際脆碎齊倅伜儕嘶埣壻崔悽扠摧撕擠晢寨樶毳淬淒濟灑犲眥眦砌齋篩簔綵縡纔腮萋齎躋釵齏韲顋歲三井切在佐材幸斉差財殺衰埼紫税婿罪雑騒碕雜騷滓猜臍蔡豺賽骰鰓殺
さいな	苛嘖
さいの	幸
さいわ	幸倖禄禎祺禧
さいわい	幸祉釐
さえ	冴朗紗斎
さえぎ	遮
さえず	哢囀
さえる	冴
さお	竿棹
さか	坂阪逆祥壮早作祁昌栄咲酒盛賢積榮垠
さかい	堺境圻畍
さかえ	昌栄榮
さかき	榊
さかさま	倒
さかずき	杯盃鍾卮巵觚
さかだる	櫑罍
さかづき	尽
さかな	肴魚
さかのぼ	遡泝溯
さかみち	嶝
さから	忤
さかり	盛
さかん	史目旺林属弉
さが	性相捜探搜
さがん	目
さき	先尖幸咲崎碕﨑匂向往東岬前埼笹嵜曩
さきがけ	魁
さきばらい	蹕
さきよ	聖
さぎ	匂鷺
さく	冊作削昨柵朔窄索雀策酢搾数錯咋做册嘖愬槊槭炸筴簇縒鵲齪咲捉責爵柞筰醋鑿
さくせ	鑿
さくぼ	窪
さくら	桜櫻
さくらが	桜櫻
さぐ	探摸
さけ	酒鮭号叫嘖
さけのつかさ	酋
さけび	哘
さげ	提
さげす	蔑
さこ	硲迫浴逧
さご	砂
ささ	笹篠支雀捧朝碍
ささぎ	陵
ささや	囁聶
ささら	簓
さざ	貞
さざなみ	漣
さざら	礫
さし	幸刺指差挿蔵藏插緡
さしがね	矩
さしはさ	挟縉
さしわたし	径逕
さじ	匙
さす	刺指摩戡扨
さすが	遉
さず	教授
さそ	笹誘
さそう	哘
さそり	蠍
さぞ	嘸
さた	聡定
さだ	貞禎安定段断尊節
さち	幸祐禎薩久拶祥撮撒擦
さっ	冊殺薩札早沙作幸刷咲昨粟察錯擦颯
さっか	目属
さっぷ	寒
さっぽ	札
さつ	冊札刷拶殺察撮撒擦薩刹册扎箚殺咲差颯紮
さつか	目
さつき	皐皋
さて	偖扠扨
さと	仁吏里誠了知怜恵悟哲敏郷理覚智解聖聡慧諭惠曉嶷聰覺觧閭黠鄕
さとい	智敏
さとし	里怜哲敏啓智聖聡慧賢了省恵詔説
さとす	啓
さとる	哲理智聡慧識
さな	真眞
さなぎ	蛹
さなだ	絛
さぬ	讃
さね	允実核一重實
さのり	紀
さば	鯖裁捌
さひろ	太宏
さび	寂錆淋銹鏥
さぶ	三
さま	様樣態
さまた	妨碍
さまよ	彷徊徘徨
さみ	寂淋網
さむ	虫凄寒淒蟲
さむらい	侍士
さめ	鮫雨醒鯊
さめが	醒
さや	鞘室紗彩清爽莢
さら	皿更晒曝濬
さらし	晒
さる	申猿
さわ	沢澤早爽粟寒触障騒騷皋觸譟閙隰
さわら	椹鰆
さわん	沢澤
さを	勇
さん	三山参柵珊桟蚕残惨産斬傘散算酸撒賛撰燦纂讃餐蒜刪參孱嶄巉怎慘慙慚懴戔攅棧槧汕潺潸粲糂繖纉纔蠶衫贊跚鏨鑽鑚閂驂產生杉寒様暫簒爨芟讚
さんしょううお	鯢
さんじゅう	世丗
さんち	珊
ざ	坐座挫嵯嵳三左決佐沙坂砂鹿戯蔵謝藏蓙
ざい	在材宰剤財載罪劑摧寨濟眥眦纔薺才西斉哉栽済祭斎細菜裁歳際齊齋
ざえ	才
ざお	竿棹
ざか	坂酒阪
ざかい	境
ざかな	魚
ざき	崎岬咲埼嵜
ざぎ	崎
ざく	尺冊昨酢裂
ざくら	桜櫻
ざけ	酒鮭
ざこ	廻迫
ざさ	笹
ざし	差射
ざっ	雑雜
ざつ	雑雜襍
ざと	里郷鄕
ざね	実真眞實
ざぶ	三
ざま	態様樣
ざむらい	侍
ざめ	覚鮫覺
ざや	鞘
ざら	皿
ざらし	晒
ざる	笊
ざれ	戯戲
ざわ	沢澤
ざん	残惨斬暫嶄巉慘慙慚懴戔攅槧殘鏨三山岸参桟産算參塹懺棧竄讒
し	士子之巳支止氏仕仔司史四市示只矢此旨死糸至字寺次自弛伺志孜私使刺始姉枝祉肢事祇姿思指施師紙脂時砥梓脚視偲埴斯紫詞歯嵐嗣獅詩試資飼蒔誌雌賜諮織識飴匙屍笥覗髭恣摯亊俟卮厠厮呰咨咫啻嗜嗤嘶址塒孳巵帋廁廝弑徙恃揣撕朿枳梔沚瓷畤痣眥眦祀竢笶篩粢絲緇縒纃緕耆耜茲葹蓍薺蚩謚貲齎趾釶錙阯駟鯔鰤鷙齒祉視飼也仁石占芝吏沙似寿住尿侍斉知妹茂茨柿食信神是染差衰凍馬倭強執清閉絞滋塩慈辞新痴磁漬締敷積磯篠璽宍壽侈俾嘴屎妛岻幟懋殞沁泗滓溲熾祠罔翅肆舐諡輜閇鴟鵄鹽
しあわ	幸倖
しい	弑強椎
しいた	虐
しいな	秕粃
しいの	椎
しう	荘章莊
しお	汐塩潮鹽萎葦栞
しおから	醢
しおが	塩鹽
しおさえ	押
しおの	塩鹽
しか	鹿叱而然飾兪聢詆顰𠮟
しかばね	屍
しかり	爾雁然尓
しがら	柵
しがらみ	柵
しき	式色拭織識鋪厠廁昃穡薔軾餝城側測飾敷頻職漉荐
しきがわら	甃甎
しきの	色
しきみ	梱樒櫁軾
しきり	仍
しぎ	鴫鷸
しく	敷鋪
しぐま	羆
しげ	林栄重草恵慈誠薫樹繁穣允成秀臣茂滋順誉蕃篤鎮瀬欝榮鎭孳茲譽薰
しげし	繁
しげる	重茸蕃繁滋楙
しこ	重醜痼
しこう	然
しころ	錏錣鐚
しし	肉獅宍穴鹿猪
ししびしお	醢
しじ	榻
しじか	蹙
しじみ	蜆
しず	靖静賎靜沈没倭閑湛禅鎮填鎭汨沒湎賤闃
しずか	静靜
しずく	雫滴
した	下舌設慕親簧
したが	従倭順随馴遜隷從从徇扈
したがき	稿
したた	強溜滴認澑
しだし	出
しち	七叱失室悉質蛭喞瑟蝨蟋貭隲漆膝櫛桎
しっ	叱失疾執湿嫉漆濕𠮟七尻卓悉質櫛
しっぽ	卓
しつ	七叱失実室疾執悉湿嫉漆質櫛蛭濕喞瑟蝨蟋貭隲隰𠮟竹膝桎
しつけ	躾
しづ	静靜
しで	椣
しと	尿淑
しとぎ	粢
しとね	茵蓐袵
しとみ	蔀
しな	姿品科級萎階葦稲靭稻嫋粃
しに	死
しね	稲
しの	篠忍凌笹偲駕筱
しのびごと	誄
しのぶ	仁荵
しは	芝
しば	芝柴縛
しばしば	屡亟
しばら	頃暫姑
しび	鮪痲
しぶ	渋澁澀
しぶき	沫
しべ	蕊標蘂蕋
しぼ	忍柴萎絞葦搾凋皺
しぼり	絞
しま	洲島嶋縞嶌陦
しまり	締
しむ	占
しめ	締示湿観諜濕
しも	下霜
しもがさ	痔
しもと	楚笞
しもの	下
しもべ	僕台隷僮隸
しゃ	叉写沙社車些舎者砂柘射紗借捨赦斜這煮裟遮謝姐咋俥偖冩嗄奢寫扠灑畭舍莎鮓鯊鷓社者煮且庄赤邪卸査差蛇釈詐杓娑洒瀉炙藉赭釋
しゃが	嗄躑
しゃく	勺尺灼借酌脊釈雀戚錫爵蹟咋杓册嘖妁愬斫槭淅爍磧筴綽蜥螫裼跖蹐釋鑠鵲鶺冊斥石赤折刺昔析削柵窄索隻惜責策跡適潟錯積績勣嚼癪芍
しゃけ	鮭
しゃこ	積
しゃち	鯱
しゃっ	借尺赤釈釋
しゃべ	喋
しゃも	鶤
しゃん	上春
しゅ	手主守朱舟秀取呪周狩首柊殊珠酒終須痩萩腫蒐数種竪趣諏撞鐘穐鰍鍾趨从咒啾娵娶悚慫枩棕椶楸淞甃皺龝籔綉聳艘艟茱蒭蚣螽豎踵蹤鄒銖銹鏥陬鞦駲麈充松注臭祝株修従捜週宿衆需銃衝鋳憧樹獣縦輸醜繍侏橦洙繻
しゅう	手収囚守州舟秀呪周宗首拾洲秋臭柊修袖執終習週就衆集萩葺愁蒐酬嵩輯鍬醜蹴襲鷲穐鰍綬繍讐酋什收羞咒售啾岫帚愀楸楫澀甃皺龝綉緝聳菘菷螽讎蹤遒逎銹鏥隰鞦駲鰌臭繡十主汁羽充寿受昇枢狩祝春授渋宿崇湿焼銃獣夙脩燒聚蓚褶驟祝
しゅうとめ	姑
しゅく	叔祝宿淑粛粥縮蹴夙俶孰槭倏鬻肅菽蓿蹙祝透塾熟
しゅち	卆恤蟀卒帥率
しゅっ	出宿
しゅつ	出卆恤朮蟀齣述卒帥術
しゅね	俊
しゅん	俊春峻隼惇竣舜遁馴醇駿瞬諄儁凖吮徇恂惷濬皴笋脣荀蓴蕣雋鰆旬巡迅盾准殉純唇淳循順楯準遵悛浚蠢逡
しゅんせ	浚
しょ	処疋初杵所狙書恕渚庶埜暑疏署楚緒諸曙黍薯藷岨鼠舒處嶼敘杼沮爼砠苴蜍踈雎鼡齟暑署緖諸小且序松阻叙徐煮疎塩礎翔墅墸胥蔗蹠鹽
しょう	小升少召正生匠庄丞羊床抄肖尚承招昇昌松沼姓性昭省相洋笈哨宵将消症祥称笑秤商唱捷梢渉章紹菖訟爽甥勝掌晶湘焼焦硝粧証詔象晴装葉腫傷奨照詳聖種嘗彰裳障摺樟蕉衝賞噌憧錆鞘醒鍬篠償礁鐘甑鯖妾娼廠樵蒋醤鉦鍾鎗蛸橡將翔裝頌奬燒从倡倩剏剿劭勦燮嘯囁墻妝嫦孀峭嶂庠廂悚愀慫慴慯慵憔抓拯搶敞旌枩椒椄楫檣歃歙浹淞漿瀟炒烝牆猖獎甞睫稍稱筱簫聳聶腥艟艢菁蕭薔蚣蜻襄誚諍證踵蹌邵鈔銷錚鏘陞霄霎韶顳驤鬆鮹鱆鱶鷦涉祥醬尙上井爪扱壮争秀声征青咲削乗政星牲荘修従挿剰常清接創湯塩蒸摂想精槍像請縄箱縦整霜莊從笙縱奘悄懾殤牀猩璋瘴竦聲觴誦逍鹽蔣靑淸精
しょく	式色拭食埴粟喰植殖飾触続嘱燭織職蝕喞囑寔昃矚禝穡薔觸軾餝即束足卓促俗息属趣識嗇稷謖贖
しょっ	食触燭織職蜀觸
しょの	餉
しょろ	寄
しょーと	遊
しら	白按検精監調覈
しらべ	調
しらみ	蝨
しり	尻知
しりがい	鞦
しりぞ	斥却退卻黜
しる	汁印記
しるし	印瑞徽徴標験璽
しるす	紀註
しるべ	標
しれ	知
しろ	代白城皎皚
しろがね	銀
しろぎぬ	縞
しわ	塩皴皺鹽
しわぶ	咳
しわぶき	咳謦
しを	夫雄
しん	心申伸臣芯身辛辰信侵神津唇娠振晋浸真秦針訊深紳進森診寝慎新腎榛賑槙審震薪親疹矧侭眞愼寢哂嗔忱怎晉沁潯甄畛瞋縉罧脣臻蓁蔘蕈蜃袗襯譖譛讖贐軫鐔駸齔神尽迅沈欣参枕甚清探普請宍晨呻宸岑抻斟滲瀋箴鍼
しんがり	殿
しー	煕
じ	二巳仁父司示字寺次而耳自地似児事侍治持時詞滋慈蒔辞馳路爾磁餌璽飴匙痔迩兒亊弍俟塒孳尓峙怩恃珥瓷畤眥眦穉竢粫耆耜膩茲薺謚貮踟轜辭十人久士子之牛支氏心夫仕仔史四市尼旨死至弐志芽茅枝知林茨柿食神甚政染柱師脂除値視進智遅道嗣獅試飼稚漬締樹薙瀬爺渕舐瀨
じい	爺
じお	塩鹽
じか	直鹿鏡
じき	直埴喰植蝕寔食値殖境敷
じく	肉竺柚軸宍忸衄竹逐
じしゃ	轜
じじい	爺
じた	舌
じち	実嫉帙姪疾秩質
じっ	十実實入拾勢昵
じつ	日実實眤衵十
じな	品
じに	死
じね	笹
じの	師
じば	芝
じま	嶋島縞
じみ	染
じめ	占締
じも	霜
じゃ	邪若蛇惹貰乍柤槎写社舎者査砂茶射馬斜雀戯謝奢寫闍麝
じゃく	勺石汐若廻荻弱寂雀惹碩杓廸瘠糴蓆躑鉐鵲夕尺宅択沢昔射酌席著笛着敵箸籍迹
じゃっ	弱寂惹
じゃん	雀政
じゅ	入寿受呪珠袖授需竪儒樹濡鷲綬嬬頌壽从咒售孺岫愀慵泅茱襦讎豎遒逎銖鰌手囚守住茅乳殊従訟就愁酬種趣雛讐酋從戍聚
じゅう	十入廿汁充住拾柔重従酎紐渋紬銃獣縦頭什戎從澁縱獸从儔廚揉楫泅澀狃畴籀糅綢蹂躊鈕隰鞣中仲虫沖寿宙秋柱終習集厨輯襲鷲絨聚胄
じゅうと	舅
じゅく	塾熟孰宿淑
じゅち	朮
じゅっ	十述術熟
じゅつ	述術恤朮十
じゅん	旬巡盾准殉純隼淳惇絢閏循順楯準馴潤遵醇諄凖吮徇恂笋脣荀蓴閠俊唇洵詢筍
じょ	女汝如助序所叙徐恕除埜曙儲薯藷鋤苧敍佇敘杼洳竚紵耡茹蜍躇齟書野署緒箸舒抒絮
じょう	上丈允冗庄丞兆羊条杖状帖長定乗城浄茸祥庭挺捷剰常情捻場畳喋蒸溺靖嘗裳肇調鄭縄壌嬢錠穣譲醸樵擾瀞乘條淨剩櫂孃疊穰讓釀仍劭囁塲壤嫋嫦崢弉憔拯掟攘梃楪樔橈渟澂烝甞疉疂禳窕絛繩聶膓萇蕘蜩襄誂誚諚躡遶邵酲鑷韶顳驤髫鰈齠狀井牛正生匠成床町呈廷尿尚承昌姓性青門政星荘挑亭貞訂娘尉渉紹盛巣頂停朝程傷照誠牒腸跳静認澄請潮蝶濃償鎖懲醤諜銚莊靜仗嬲掾滌繞饒醬
じょうの	城
じょく	辱溽蓐匿濁縟褥
じょん	正鐘
じら	白
じらみ	虱
じり	尻
じる	汁
じるし	印
じろ	白城
じん	人刃仁壬尽迅臣辰神甚秦訊陣尋湛腎稔荏塵靭侭盡仭刄姙忱恁棯潯糂荵蕈蕁袵贐鐔靱鴆神心任沈妊忍参珍針朕深進陳診慎賃認鎮仞參燼衽酖
じんこう	樒櫁
す	子州寿取周枢洲素巣須酢湊聡諏雛蘇笥趨葱薮偬嗾娵娶帚怱愡愬掫棕椶簇籔粽菷蒭蘓赱輳酥陬麁麈巢十寸収日右司主吸好守朱角住助抄走刷注直皇奏送珠修栖租透済捨釈週崇据措粗組陶過隅衆棲訴惣統棄隙嵩数塑鈴酸需摺遡総綜趣澄鋳摩錯樹輸擦簾鷲漉鋤苧剃剥壽鑄吮弃掏搨數樔泝溯澂濟簀耡軼饐
すい	水吹垂炊帥粋衰推酔遂睡瑞翠穂錐錘彗粹醉穗埀埣悴忰惴捶揣榱瘁祟翆隋膵膸雖陲隧騅出吸西杉剤率随椎誰髄邃萃
すう	枢崇嵩数雛趨怱數樞甃皺籔粽菘蒭鄒陬秀愁芻
すえ	末据未季居陶甄
すか	砂渚鳥賺
すが	菅清管縋
すがた	姿態
すがめ	眇
すき	隙鍬鋤次透銭漉梳犂犁耜耡釁銛
すぎ	杉椙生叩枌
すぎる	宕
すく	槭蓿蹙少句匡丞抄叔城掬救済宿淑粛縮蹴夙抔拯贍
すくな	寡尠
すくも	粭糘
すぐ	直傑駿優儁儻杰雋
すぐる	俊豪卓
すけ	允友丞助甫佑昌哉祐亮裕資輔弼之介右佐侍典補賃
すけっ	助
すげ	菅
すげの	菅
すこ	少健
すこぶ	頗
すご	凄菅淒
すさ	荒凄淒
すし	鮓
すじ	筋条脈統絡線綫脉
すす	洗晋進雪勧奨煤澄薦膳濯勸啜廸慂慫晉歃獎陟
すすき	薄芒
すすみ	晋
すすむ	生将晋一奏
すすりな	歔
すず	紗鈴錫鐸涼篶鈬鑾
すずき	鱸
すずめ	雀
すずめの	雀
すずり	硯
すそ	裾
すた	廃廢
すだま	魅魑
すだれ	箔簾
すち	齣
すっ	寿壽
すっぽん	鼇
すて	捨
すで	既旣
すな	沙砂直
すなお	淳惇
すなわ	乃即廼輙迺
すなわち	曽曾而輒
すね	脚強臑
すの	洲春墨簀
すのり	規
すばる	昴
すべ	凡全術滑総辷
すべか	須
すべて	総
すぼ	窄
すまし	清
すみ	紀炭純栖清隅隈墨澄墨了角寿住速綴燈壽亟陬
すみの	住
すみれ	菫
すむ	済
すめ	皇
すめらぎ	皇
すも	宙
すもも	李
すり	摺磨擦擂
する	摺駿
するど	尖犀鋭銳
するめ	鯣
すわ	坐座
すわえ	楚
すん	寸駿舜澄
すー	徐蘇
ず	手図杜逗酢厨頭吋屠菟弗頌亊圖廚揄淙竇肚荳讎跿骰子主尽辻寿住投豆刷事受洲津殊珠栖徒途済訟巣都集須痘瑞塗鈴酸読樹擦叢鶴讐壽誦巢
ずい	随瑞錘髄蕊彗埀悴忰惴痿瘁縋隋膸蕋隨陏陲隧髓水垂泉遂椎睡槌誰墜穂鎚
ずいむし	螟
ずう	桐銅僮慟淙潼粡艟洞通胴崇動筒童数瞳數
ずえ	末
ずか	好塚
ずき	月附
ずきん	帽
ずく	竹授熟
ずくり	造
ずさ	橲總
ずし	鮨
ずち	朮述術
ずつ	宛
ずな	網
ずぼん	袴
ずま	瀦潴
ずまさ	秦
ずみ	棲澄角住祇炭純済墨積曇濟
ずめ	詰
ずり	摺刷
ずる	鶴
ずれ	連
ずん	寸
せ	世施背脊貰勢聖蓑製瀬灘丗扠樶灑篩簔葹蛻釵瀨兄生西局攻声谷忍季所制姓迫哉洗差晒衰畝斎清責旋堰税債催塞説頼競咳逼竸畆聲誚賴
せい	井切世正生成西声妻制姓征性青斉省政星牲洗背凄栖逝脊祭清盛甥犀晴棲婿貰勢聖誠靖精製誓静請錆整醒鯖鉦脆瀞彗齊靜倩儕丗嘶噬壻彁悽撕擠旌晢毳淒眥眦砌聲腥萋菁薺蛻蜻齎躋齏韲靑淸晴精汐芹城浄浩剤殺泰済細粛情晶証税歳蒸際説瀬晟惺掣睛穽肅臍霽歲
せがれ	倅伜悴忰
せき	夕斥石汐赤昔析隻席脊惜戚責堰跡関碩錫積績蹟籍咳晰槭淅瘠磧蓆蜥螫裼跖蹐鉐關鶺尺折刺射借釈寂適潟勣皙碵
せきばらい	謦
せく	齪
せぐく	跼
せこ	迫
せち	切屑雪察洩凖啜扎晢毳紲絏緤薛褻札折刷拙契窃殺清設準節説節
せっ	拙窃設摂攝竊切石赤折殺隻席接雪節説積瀬楔浙瀨
せつ	切折拙窃屑接設雪摂節説洩鱈刹攝凖啜晢椄毳泄竊紲絏緤薛褻鞨節說哀契殺哲絶準截渫殺
せの	妹勢
せば	狭狹
せぼね	呂
せま	迫狭拶窄狹狷褊蹙遒逎阨齪
せみ	蝉蜩蟬
せむし	佝傴
せめ	鬩
せり	芹糴糶
せりょ	芹
せわ	忙
せん	山千川仙占先尖亘茜宣専泉浅洗染穿扇栓閃釧斬旋船揃戦煎羨腺詮践銭銑撰潜線選遷薦膳繊鮮鹸蝉栴煽箭舛賎苫專箋戰纖亶仟倩僉僣刪剪吮嬋孅尠孱愃懴戔擶旃暹槧槫殲殱汕淺湶潺潸潛濳濺燹牋甎痊瞻磚笘籖綫纔纎羶譱臉荐蟾衫贍跣踐銓銛錢鐫闡阡陝雋韆顫全串杉柵前単桟産善禅漸還繕僊僭擅氈疝癬盞筌筅簽籤翦蘚譫賤餞饌
せんざ	芹
せんち	珊
せんちぐらむ	甅
せんちめーとる	糎
せんちりっとる	竰
せんの	千仙
ぜ	是柴砦膳儕摧犲眥眦世所前背勢誓慮瀬瀨
ぜい	税脆彗噬毳蚋蛻贅稅西城泉背情盛勢誓説筮說
ぜき	跡関咳藉關
ぜち	舌鞨絶
ぜっ	絶舌節
ぜつ	舌絶鞨絕説熱
ぜに	銭錢湶
ぜにさし	繦
ぜま	狭狹
ぜみ	蝉蟬
ぜろ	零
ぜん	全染前善然禅漸撰膳繕蝉賎禪亶冉吮喘嬋孱嶄巉槫涎潺濳譱苒蟾贍鏨雋山仙宣泉単桟旋船軟践銭潜還燃蠕錢髯蟬
そ	狙阻祖租素措曽粗組曾疏疎訴塑楚遡綜噌礎蘇鋤岨鼠囎愬沮爼砠耡胙苴蘓踈酥雎麁鼡齟祖十反且甲生疋早佐初助宋来沿宗所征卒其削染荘殺逸添酢惣尊湊想錯磯剃來莊俎厥咀徂梳泝溯疽祚蔬詛
そい	添副襲
そう	双庄壮早争宋走宗奏相草荘送笈桑倉捜挿梢曽爽掃曹巣窓湘曾創喪惣痩葬装湊僧想蒼層槍漕総綜聡遭諏噌槽鞘操燥霜叢騒藻鯵竃甑蒋醤匝掻糟鎗蛸葱蚤薮壯爭莊搜裝漱踪騷偬剏剿勦卅雙嗾囃妝嫂孀崢帚廂弉怱愡慥懆抓掫插搶梍棕椶棗樔歃淙澀澡炒獎稍窗簇籔粽總臧艘艚菷襄諍譟賍赱蹌躁輳鈔錚鏘陬襍霎驤髞鮹鱶巢僧瘦層揷三爪生扱床抄状沢茅哨将造渋崇粟粧蒐奨雑増憎蔵箱錆磯贈繰臓匆叟嗽噪愴滄澤瘡箏筝聰艙贈搔
そうじて	惣
そうろう	候
そえ	弐添副傍
そえうま	驂
そお	宗
そぎ	枌祓
そく	即束足促則息捉速側粟測塞数燭厠喞廁昃矚禝穡簇薔戝卽族触賊趣嘱仄惻熄
そこ	底残損椢
そこな	害損
そし	誹詆譏譖譛
そそ	沃注笹雪潅溌澆濺灑
そそのか	唆嗾
そぞ	漫
そぞろ	坐
そだ	育毓
そち	倅伜卆埣猝卒帥率
そっ	即卒速側率測卆卽
そつ	卒率倅伜卆埣猝蟀帥
そで	袖
そと	外
そな	供具備膳
そね	妬嫉
その	苑園爾薗苜其彼囿
そば	蕎岨側傍
そばだ	崛欹
そばめ	妾
そび	聳
そま	杣
そむ	伐背舛叛
そめ	染
そも	甚
そら	空宙昊穹徂旻諳霄
そり	反剃橇膤艝轌釖
それ	厥
それがし	某
そろ	対具斉揃算
そん	存村孫尊巽損遜噂樽鱒墫拵糂蹲驂寸成参松惨算忖邨
そんじ	松
ぞ	沮胙衣沿宗染祖座曽須曾僧
ぞい	添
ぞう	三造曽象曾雑像増憎蔵贈臓橡藏雜臟墻庠弉慥梍檣淙牆艚艢薔賍襍增憎贈双匠作相草祥曹詳僧層漕槽藤雙贓
ぞえ	沿添副
ぞく	俗族粟属賊続屬簇續戝束足蔟鏃
ぞこ	底
ぞっ	俗属続屬續
ぞの	薗苑園
ぞむ	望
ぞめ	初染
ぞら	空
ぞれ	嵐
ぞん	存鱒拵蹲蚕尊
た	太他田多汰陀唾舵楕詫詑柁騨它岔橢沱隋躱鴕大手丹天反右玉仔立足妥谷垂炊忠屋建食耐炭茶発起経蛇断閉隆堪裁植絶堕惰達貯焚蓋溜駄竪矯藤咫咤埀夛斷殄澑闌絕
たい	大太代台体対低苔耐待怠胎退度秦帯泰砥堆袋逮梯替貸隊敦碓滞態醍戴鯛岱腿鎚剃畷呆帶滯嚔嚏對擡抬楴洟涕玳紿羝臺蒂蔕薹蛻裼觝詒詆軆輟錣鐓靆體平夷当汰底抵邸毒帝殆能推脱堤等綴鋭黛諦薙當褪頽颱駘
たいの	鯛
たいら	平坦砥
たいらの	平
たう	允
たえ	紗才妙耐栲
たお	倒島桃顛仆僵垰嫋嵶殪
たおやか	婀
たか	生宇考孝臣廷伯岳宜尚卓剛能崇琢隆象登聖誉賢鷹一宅竹亘応社延享尭昂宗武宝挙恭高峻将哲峰堂貴喬敬就集尊雄義嵩銘稼毅顧堯倬寶岌崛嶽巍敞杲譽
たかし	大孝享尭昂尚卓郁俊峻皐崇隆貴喬嵩丘岐律巍敞髞
たかつき	鐙
たかどの	楼閣
たかの	鷹
たかぶ	昂
たかむ	崇
たかむら	篁
たから	宝寶珍財寳貲
たかんな	笋
たが	互逓爽違箍靠
たがね	鏨
たがや	耕墾畊畉
たき	滝瀧炊焚薫薰
たきぎ	薪蕘
たきの	建滝瀧
たぎ	滾
たく	宅托択沢卓拓啄託琢詫濯擢鐸櫂倬啅戳拆擇柝澤躅鈬功巧匠坦度摘濁
たくみ	工巧匠
たくら	企
たくわ	貯蓄儲
たぐ	比類類
たぐい	比類双伉畴
たけ	丈竹岳孟威茸健雄嵩豪毅斌赳嶽壮宅長武和建剛崇猛尊傑誉穀壯蕈
たけき	彪
たけし	孟威剛健彪豪毅武驍
たけなわ	酣闌
たけの	竹炬
たけのこ	筍笋
たけん	岳武
たこ	凧蛸竹鮹鱆
たご	宕
たし	足達碓確慥
たしな	窘
たじ	丹但
たす	右丞助扶佑毘祐輔賛弼
たすき	襷
たすく	佑祐亮輔弼
たず	訊訪温尋鶴
たずさ	携攜
たずな	羇
たた	忠称畳湛賛讃叩頌疊扣疉祟
たたか	戦闘戰鬪
たたず	佇
たたずむ	竚
たたみ	畳疊疉疂
たたむ	疂
たたら	鑪
ただ	允只考斉忠紀宰惟聖一正匡但径征直糾貞格唯弾雅禎維質縄飭啻尹擶糜逕
ただし	匡侃忠紀貞矩規理雅禎端肇旦但督
ただす	董紀
ただよ	汎漂漾
たち	舘妲怛逹闥日立城脱陸達質館貭
たちき	樹
たちばな	橘
たちばなの	橘
たちま	忽乍
たちまち	奄倏
たちもとお	裴躑
たっ	立多宅辰卓竜達龍磔謫
たっちゅ	塔
たっと	貴尊
たつ	辰竜達龍妲怛逹錣闥田立建起健脱塔奪竪蔦樹瀧撻燵
たつき	樹
たつの	辰滝瀧
たつみ	巽
たつる	樹
たづな	轡覊
たて	盾健楯竪館縦舘縱立奉建帯賢帶蓼豎
たていと	経
たてがみ	鬣
たてまつ	亨奉献
たで	蓼
たと	例譬
たど	辿
たな	棚店種廛
たなごころ	掬掌
たに	谷澗渓壑峪溪
たにがわ	渓
たぬき	狸貍
たね	胤種稙
たの	托愉楽嬉嘱頼樂佚恃熈賴
たは	敬
たば	束刃把抱
たばか	謀誑
たばこ	莨
たばみ	漿
たび	度旅羇襪覊韈
たふ	允椨
たぶ	椨
たぶさ	髻
たぶら	誑
たぼ	髱
たま	玉圭玖玲球弾碧霊珪彈靈珠偶堪給瑞魂賜澑賚
たまき	環鐶
たまご	卵孚
たましい	魂
たまの	楡
たまもの	賚
たまや	廟
たまり	溜澑
たまわ	賜
たみ	民仁丹氓
たむろ	屯
ため	為溜試験爲澑
ためら	躇躊
たも	保給賜
たもつ	維
たもと	袂
たゆ	弛
たよ	便頼賴
たら	鱈垂荒誑鰔
たり	足谷垂渡
たる	善樽弛垂滴熾
たるき	桷椽榱
たれ	垂誰孰
たれがみ	髦
たわ	乢嵶橈
たわむ	弄戯戲謔
たわむれ	詼
たわら	俵
たん	丹旦坦担単炭胆耽探淡湛短嘆端綻歎誕鍛檀灘騨箪椴單亶啗壜彖慱擔摶攤槫檐殫毯湍猯眈簟罎膽葮蕁蜑袒襌褝襷覃賺赧鄲鐔餤嘆簞反田団但谷段唐断堪弾湯談壇曇蛋呑啖憚憺潭澹痰站譚酖靼
たんの	淡
たー	重
だ	大打田妥陀雫蛇唾舵堕惰楕駄難詑柁騨梛儺墮娜拏橢沱糯隋陏鴕驒太出立多那炊奈抱建第達佗兌懦拿朶荼躰駝
だい	乃大代台苔妹殆悌逮第梯醍蹄戴鵜題鯛岱廼擡棣玳睇紿臺薹詒迺鐓靆餒髢太内体弟毒奈耐待怠逓能袋隊提滞態鋭締體內
だいだい	橙
だいら	平
だお	倒
だか	高鷹
だから	宝寶
だかり	渠
だき	抱滝瀧
だく	度諾濁擢鐸櫂躅鈬沢濯澤
だけ	岳嶽丈竹武嵩
だこ	凧蛸
だし	出
だたみ	畳疊
だち	達逹立脱裁奪
だっ	脱奪韃
だつ	脱捺奪妲怛脫達
だて	立点楯館舘點
だな	棚灘
だに	谷渓溪
だぬき	狸
だね	種
だま	玉珠弾魂黙霊彈默靈騙
だら	渡鱈
だらい	盥
だる	怠樽
だれ	誰垂
だわら	俵
だを	男
だん	旦団男段南断弾暖楠談壇檀難灘騨蛋椴團彈啗娚慱摶斷槫葮蜑袒赧餤玉但坦淡誕箪煖疸簞
ち	千血地弛池茅治知乳持値恥致植智遅痴稚置馳徴薙痔蜘緻抬癡穉笞耻胝貭踟躓輊遲魑一七刃右市佐些祉昌和津喜散道質盤禿仟褫
ちぁん	江
ちい	小
ちいわし	鰯
ちえ	恒恆
ちか	允史考哉峻悌慈慎睦爾親隣力寸央近周恭規幾誓鎮迩
ちかし	爾迩
ちから	力税
ちが	違
ちがや	茅
ちき	飭陟勅捗
ちきり	巾椦
ちぎ	契
ちく	竹竺畜逐筑蓄築矗柚軸
ちぐせ	癖
ちさ	苣
ちすじ	胄
ちち	父乳膣腟秩窒爺
ちぢ	縮
ちっ	窒竹些秩築蟄
ちつ	秩窒帙膣腟姪蟄
ちどり	鵆
ちな	因
ちぬ	釁
ちの	茅
ちのみご	孺
ちぶえ	笛
ちまき	粽
ちまた	巷
ちゃ	茶詫爺
ちゃく	的着嫡鏑俶拆躇逖著摘滴適箸
ちゃっ	着
ちゃん	昌
ちゅ	中
ちゅう	丑中仲虫沖宙忠抽注昼柱衷酎紐紬厨註鋳駐晝鑄偸儔冑冢廚惆狆疇畴籀綢蛛蟲躊鈕鍮住肘株冲稠紂胄誅
ちゅち	黜
ちゅつ	朮黜
ちゅん	椿屯仲春
ちょ	猪著貯儲樗瀦苧佇杼楮竚紵豬躇著除緒箸緖
ちょう	丁丈弔庁汀兆杖町帖長重挑釘帳張彫眺頂鳥釣場喋朝脹超貼牒腸跳禎鼎徴暢蔦肇澄潮蝶調聴懲鯛寵凋諜銚吊碇嘲聽廳冢啅塲廰悵昶楪樢沾漲澂甼疉疂窕笘箚糶罩膓萇蜩蟶誂輒輙遉酊雕騁髫鰈齠徵懲打灯条貞訂敏渉停偵畳塚提艇錠樗佻掉晁疔貂趙迢
ちょく	直勅捗飭敕躅陟値
ちょっ	直勅敕
ちょる	哲
ちょん	鄭
ちり	塵
ちりば	鏤
ちる	生散
ちん	沈珍砧朕陳湛賃椿鎮疹塵填鎭碪趁鍖鴆灯青枕亭陣清診隠慶燈抻狆珎趾酖闖隱
ちんた	青
ぢ	血地池知
ぢか	近
ぢから	力
ぢゃ	茶
っぱな	放
つ	津兜都堵賭菟偸兔抖睹肚蚪蠹蠧覩鍮鬪都十土斗廿付次尽吐亜告即兎拓注妬突附威厚美律通透連黄悉紹接釣越就着貼棟詰継漬摘衝徹撞積築闘吊葎恆奧盡抓搶搗擣椄殄殫渫燵繼纉誥踵酘突黃吿
つい	対追堆椎敦槌墜錘築鎚對縋立序卒叙終推遂費衝潰
ついたち	朔
ついで	序敘
ついに	卆
ついば	啄喋
つう	通桶痛樋鶇鶫東凍棟董
つえ	杖枴梃
つか	杷塚埠塚支仕司尽束労使柄倦疲捕筑遣掴冢劬拏痞瘁羸閊
つかい	使徭
つかさ	寮工司台曹務嗣
つかさど	司
つかの	塚
つが	栂番樛
つがい	番
つがね	束
つき	月槻築付尽突附宮属着継坏屬憑欟繼舂鴾
つぎ	次胤嗣二亜接族継亞繼
つく	啄筑作佃附造悉創属做殱竭
つくえ	机案
つくした	韈
つくだ	佃
つくづく	熟
つくばう	蹲
つくも	白
つくり	作造
つくる	作
つくろ	繕
つぐ	序承胤紀禎二司次亜従継嗣維亞從頌噤拑繹繼韶
つぐな	償
つぐみ	鶇鶫
つけ	漬付附
つげ	柘
つごもり	晦
つし	対對
つじ	辻寿壽逵
つた	蔦伝傳嶌樢蘿
つたな	拙
つち	土槌鎚地椎壌
つちか	培
つちくれ	塊
つちのえ	戊
つちのと	己
つちふる	霾
つつ	筒包啄劼坡裹
つつが	恙
つつし	斎粛欽慎謹愼兢愨愿謹
つつじ	榴
つつじが	榴
つつみ	堤塘陂
つづ	廿葛続綴續
つづき	仲続續
つづま	倹
つづみ	鼓堤皷
つづら	九葛綴
つづり	綴
つづれ	綴
つて	伝
つと	孜努勉務勤夙劭劼勗懋苴勤
つとむ	功孟惇茂
つど	集
つな	紀紘綱絡繋婁緤覊
つなぎ	貫
つなぐ	紘
つなの	綱
つね	矩常庸凡永毎典恒経雅識恆彝彜抓經
つねあ	恆
つの	角都募
つば	唾鍔椿鐔
つばき	沫唾椿
つばく	凸
つばくら	燕
つばくろ	燕
つばさ	翼
つばめ	燕
つびし	菱
つぶ	粒円潰圓
つぶさ	具悉備審
つぶて	礫
つぶや	呟
つぶら	円圓
つぼ	坪壷壺窄坩
つぼね	局
つぼの	坪
つぼみ	蕾莟
つぽ	浦
つま	妻嬬爪具倹最撮抓褄
つまこ	孥
つまず	頓跌蹉躓
つまだ	跂
つまばさ	襭
つまび	詳審諦
つまみ	鈕
つみ	罪摘墨積
つむ	錘紡紬摘勣緝
つむぎ	紬
つむじかぜ	飃飆
つめ	爪冷詰
つも	妬
つもり	積
つや	艶艷沢
つゆ	露汁
つよ	毅侃剛強豪彊倔遒逎
つよい	勍
つよし	剛彪幹毅彊壮雄
つら	面辛連貫綿劉聯緜聨
つらつら	倩
つらな	洛
つらぬ	串穿貫
つらぬく	琲
つり	釣吊
つりいと	緡
つりゅ	鶴
つる	弦敦蔓鶴釣吊寉鉉霍
つるぎ	剣劍劒
つれ	連
つれあ	対
つれあい	仇逑
つわもの	兵軍戎
つを	夫雄
つんぼ	聾
づ	津付尽図連都詰漬積鶴圖
づい	髄髓
づう	同
づえ	杖
づか	司束使柄疲塚遣
づかい	遣
づき	筑築月付突槻
づく	作附造
づくえ	机
づくし	尽盡
づくり	作造
づけ	漬付附
づち	槌土鎚
づつ	砲筒
づつみ	堤
づて	伝傳
づと	勤苞
づな	綱縄繩
づの	角
づま	妻
づみ	墨積
づめ	爪詰
づもり	積
づら	辛面
づり	刷釣
づる	弦蔓鶴
て	手汀堆豊天因弟勅貞帝点泰照殿輝樋幣鎚弖豐逹點
てい	丁汀体町低呈廷弟定底抵邸亭貞帝訂庭悌挺逓釘砥停偵梯堤提程禎艇鼎綴締鄭醍諦蹄薙鵜剃碇畷嚔嚏廰掟梃棣楴洟涕渟甼睇羝蒂蔕蟶裼觝詆軆輟遉遞酊酲錣騁體髢打代庁灯袋逮第頂替滞錠聴題逞俤叮幀柢牴霆
てう	鳥
てかせ	梏
てがた	劵
てがら	閥
てき	的荻笛摘滴適敵擢鏑俶廸糴躑逖嫡剔擲狄覿
てこ	杆杠梃槓
てすり	欄闌
てち	鉄畷蛭僣啜輟銕錣鐡餮哲窒綴徹撤
てっ	撤手哲鉄適敵徹轍鐵
てつ	迭姪哲鉄綴徹撤轍畷蛭佚僣咥啜垤耋跌軼輟銕錣鐵鐡餮窒誓徳德
てつん	哲
てのひら	掌
てら	寺
てらし	輝
てらす	曜照
てり	照
てる	映栄昭晃瑛晴輝曜旭光両照皓
てれ	寺
てろ	得
てん	天田伝辿佃典店点展添転淀貼殿電槙纏填甜顛澱轉甸唸嗔囀壥廛忝畋椽殄沾沺癲篆簟纒腆覘諂躔銛鏈霑靦鷆鷏點塡顚一厘蚕傳奠巓恬輾
で	手出凸弟和豊豐
でい	泥祢禰濔袮尼
でかぐらむ	瓧
でかめーとる	籵
でかりっとる	竍
でき	溺
でく	塑
でこ	凸
でしぐらむ	瓰
でしめーとる	粉
でしりっとる	竕
でち	轍佚咥垤耋跌軼迭姪
でや	亭
でら	寺
でを	夫
でん	田伝佃捻淀湛殿電綻鮎纏填甜澱撚傳甸嗔壥廛拈畋椽殄沺簟纒袒賺躔鷆鷏黏年典念厘粘奠臀鈿
と	十土戸斗吐図兎杜利里妬徒途砥兜都堵渡登塗豊賭屠菟鍍兔圖睹肚蚪蠹蠧覩跿都戶人刀卜久刃止仁永外本吉臣采取青陀泊門研津度洞飛疾訊唐敏捕留採執釈鳥停寅冨閉訪問階勝遂等道博富遠解摂跳溶説綴撮徹頭融録藤闘騰砺釆摸熔搴櫃爍畄礪秉籘莵觧豐遏銷鑠閇硏說
とい	樋
といし	砥
とう	丁刀冬灯当任投豆沓宕東到逃桐通倒党凍唐套島桃討透桶兜逗悼盗祷陶動萄痛登塔搭棟湯痘等答筒統董稲嶋銅踏撞樋燈糖頭謄瞳藤闘騰吋塘梼淘涛蕩鐙盜稻櫂偸僮儻剳啅夲嶝帑幢慟抖掏揄搗搨擣朷档榻濤淌滕溏澂潼當疼蘯磴礑竇箚籘粡絛綢綯縢纛罩艟苳荅荳蚪螳蟷襠蹈迯釖鍮陦鞳饕骰鬪鰈鶇鶫黨鼕禱鬭十允斗父多同百沼挑洞郎胴納堂童道遠読澄導憧撓滔盪籐蓊薹讀鞜韜
とうげ	峠
とうと	貴尊
とうまる	鶤
とうみ	江
とうる	亘亨暢
とお	十柔通透悠疏遠暢徹藐逖遐
とおい	弥
とおり	通
とおる	亨享宣透理
とおるふ	亨
とかげ	蜥
とが	栂尤尖科咎
とがの	栂
とき	秋時常説穐鴇辰刻朗斎龝閧鴾
ときあかし	註
ときは	松
とぎ	伽磨
とく	竺啄匿特得督徳読篤涜禿悳慝纛讀髑黷德玉毒独註牘瀆
とぐろ	塒
とげ	刺朿
とこ	床常砧徳德
とこくさ	臭
とこしばり	輹
とこの	床
ところ	所処處攸
とざ	鎖
とし	功考年甫季宗紀哉俊要峻健淑惇順智禄稔聡肇毅繁駿才史世寿利知怜敏敦歳廉鋭憲厳齢壽嚴
としかつ	寿
としよ	眉耋
とじ	綴
とせ	歳
とち	凸橡柮栃構杤栩
とっ	突凸取独特鳥徳篤吶咄獨德
とっく	徳德
とつ	凸突頓柮突帰鳥嫁咄皈訥
とて	迚
ととの	調整
とど	届留逗稽椴屆渟畄遏鯔
とどき	届屆
とどけ	届屆
とどけい	届屆
とどこお	滞滯
とどろ	轟軣驫
とな	称唱隣倡徇鄰
となり	隣鄰
との	殿外砥渡
とば	殺
とばり	帳幌幃幎
とび	鳶飛跳鵈
とびち	溌
とびら	扉闔
とぶ	飛
とぶひ	烽
とぶら	弔
とぼ	乏
とぼそ	枢
とま	苫篷
とます	斗
とまり	泊
とみ	臣冨智富頓豊豐
とむら	弔
とむらい	弔
とめ	留
とも	丈大友共作那供奉朋和侶悌倫智誠禎興塘允公乏灯伴呂具幸治知典紀兼珠基視寅朝寛僚燈曇倶偕舳艢艫舮鞆寬
ともえ	巴
ともがら	曹輩們儕儔
ともし	灯燈
ともしび	燈燭灯
ともな	伴
ともゆ	栄榮
とや	塒
とよ	豊樋豐
とら	虎寅彪囚捉捕擒乕
とり	酉取鳥禽鷄工舎捕採部鶏
とりく	虜
とりこ	禽虜擒
とりで	柵砦塞廓塁寨
とりの	鷲
とる	抄
とろ	瀞蕩蘯
とわ	樋
とん	屯沌耽豚湛敦遁頓噸呑暾燉眈遯鐓飩団灯同東盾純通探惇問鈍富燈團瓲酖
とんび	鳶
ど	土戸奴努度怒屠鍍孥帑跿友処豆門退徒途都堂堵渡登道遠殿塗読撮燈頭曇澱處呶弩絨讀駑
どい	樋
どいつ	独
どう	同沓洞桐倒桃胴動堂萄童道働銅導憧撞瞳藤嚢膿僮儂嫐幢慟掏曩橈滕溏澂潼瑙蘯碯籘綯縢纛耨艟螳衲蹈迯鐃閙靹鬧鼕灯百豆宕東耐逃唐悩納能悼盗陶脳渡等答農稲澄燈糖頭謄騰塘梼淘涛蕩恫棠獰瞠
どうし	通
どお	通遠
どおり	通
どき	時鬨
どく	毒独特読涜獨纛讀躅髑黷得徳德
どこ	床
どころ	処所處
どし	年
どじょう	鰍鯲鰌
どち	突
どっ	毒独読獨讀
どつ	肭
どなり	隣
どの	殿
どばと	鴿
どぶ	溝
どぶがい	蚌
どまり	泊
どみ	留冨富
どめ	止留富
ども	人共供吃塘
どら	鐃鑼
どり	取鳥鶏鷄
どる	弗
どろ	泥洞瀞淤
どん	沌鈍曇噸呑貪壜嫩燉罎蕁襷覃遯鐔飩屯団灯盾純豚殿遁頓燈丼團緞
どんぐり	杼
どんぶり	丼
な	名那奈菜雫楠樹難梛儺娜拏糯七乃亡今永穴生成凪汝作投阿泣長波苗並和為南夏納流萎魚済梁無葦馴農慣嘗鳴撫薙做啾嚶拊捫涕狃狎甞痿綯罔舐褻
ない	乃内奈祢禰廼濔袮迺餒內没泥耐能袋撫
ないがし	蔑
ないし	尚
ないじょ	撫
なえ	苗秧
なお	作巨有治尚忠直修真順猶眞仍犹胖
なおあ	尚
なか	中考仲尚勿史半莫腹
なかつ	仲
なかば	央
なかま	党
なから	半
なが	亨寿栄修暢久永良呂長祥流眺乍袤
ながえ	轅
ながしめ	睥
ながめ	眺
ながやみ	痼
ながれ	流
ながわずら	痼
なき	鳴泣啼
なきはは	妣
なぎ	凪薙柳渚袋梛椥彅
なぎさ	汀渚沚瀲
なく	諾
なぐ	殴毆
なぐさ	慰
なげ	嘆歎唏喟慟欷嘆
なこ	勿粉
なこうど	妁
なご	和
なごな	粉
なさ	情
なし	勿莫梨無
なしり	後
なじ	生
なず	懐
なずな	薺
なぞ	謎
なぞら	比准準凖
なた	屶鉈
なだ	灘宥泪
なち	捺
なっ	納捺
なつ	夏捺撫懐懷
なつぞら	昊
なつめ	棗
なづる	鶴
なて	梯
なでし	撫
など	等抔
なな	七斜
ななめ	陀
なに	何那渠曷
なにがし	某
なぬ	七
なの	七菜
なば	生
なび	並
なぶ	嬲嫐
なべ	鍋銚辺滑邊邉
なま	生怠鈍艶
なまく	鈍
なまぐさ	羶腥
なまじい	憖
なまじり	眥眦睚
なます	齏韲鱠
なまず	鮎癜鮟鯰
なまた	俣
なまめ	妖
なまり	鉛訛
なみ	凡甫波並竝次列南浪蔑涛濤瀚
なみだ	涙淚涕
なみの	浪
なめ	滑嘗鞣
なめしがわ	鞣
なめり	滑
なや	悩惱蹇
なやみ	悩
なら	楢双比列均対効並倣習伉傚雙嫺嫻狃肄
ならい	習
なり	也生礼作足尚斉済晴業稔允成百形伸城詞就慈勢誠態鳴震齊
なる	考稔徳生成完育愛鳴德
なれ	汝馴
なれう	馴
なれしか	麋
なわ	縄繩苗輪
なわて	畷
なん	男南軟楠難娚難何胡烏納蓋暖灘喃盍
なんじ	乃女汝爾廼而尓迺
なんぞ	那渠奚曷瑕遐
なんな	垂
なんなんと	埀
に	二尼而弐荷爾餌迩弍尓怩珥膩貳貮轜仁丹日耳西似児逃姫理煮新煎烹兒迯邇煮
にあき	昭
にい	新兄
にう	生
にえ	贄錵
にお	匂臭鳰臭
におい	匂香
にが	苦
にがみ	神
にきび	皰靤
にぎ	和握賑
にぎり	握
にく	肉宍忸溽蓐衄辱悪嫉憎難憎
にご	濁溷
にごり	濁
にごりざけ	醪
にごる	汰
にし	西螺
にしき	錦
にしん	鯡鰊
にじ	虹躪霓
にじゅう	廿
にじり	躙
にせ	偽贋僞偐
にた	似
にち	日衵
にっ	日仁肉
につ	仁
にな	螺担擔蜷蠡
にの	二似
にぶ	鈍
にほ	薫
にゃ	若惹
にゃく	惹溺若弱蒻
にゃん	娘
にゅ	二壬丹
にゅう	入廿乳柔紐濡戎孺揉狃糅襦蹂鈕鞣冗生敷儒濃嬬涌
にょ	女汝如洳茹
にょう	尿茸捻溺穣譲擾穰仍囁佞侫嫋橈檸濘禳聶聹蕘躡遶鐃鑷閙顳鬧女如娘認寧壌嬢醸
にょく	匿
にょん	寧
にら	韮盻眈睨薤
にらぐ	淬
にれ	楡
にわ	庭圃勃猝
にわか	俄卒頓卆怱霍
にわざくら	棣
にわたずみ	潦
にわとり	鶏鷄
にん	人壬任妊忍閏稔認荏靭仭刄姙恁棯荵袵閠刃仁賃潤
にんにく	蒜
ぬ	忽孥帑耨奴努抜沼怒挺脱塗縫擢濡拔渟脫
ぬい	蕊痿蕋縫
ぬいとり	繍
ぬえ	鵺鵼
ぬか	糠糟頓額倥濘
ぬき	抜貫緯擢拔樌
ぬく	生炎貫温溫
ぬぐ	拭揩
ぬぐい	拭
ぬけ	抜拔
ぬけがら	蛻
ぬさ	幣幤
ぬし	主
ぬす	窃盗盜偸
ぬた	岱垈汢
ぬっ	沼
ぬった	沼
ぬで	椦
ぬなわ	茆蓴
ぬの	布
ぬのこ	褞
ぬま	沼
ぬめ	絖
ぬら	濡
ぬり	塗
ぬる	温塗溜溫
ぬれ	濡
ね	子音廻祢根値稔嶺禰蚋袮右如年恵称峰猫婦寝煉練錬惠寢涅鯰練
ねい	祢寧禰佞侫檸濘聹蚋袮尼苗嚀
ねえ	姐
ねえさん	姉さん
ねが	願覦
ねぎ	葱
ねぎら	労犒
ねぐら	塒
ねこ	猫
ねじ	捻捩
ねず	鼠
ねずくり	艮
ねずみ	鼠鼡
ねた	妬嫉
ねち	熱
ねっ	根熱
ねつ	熱捏
ねば	粘黏
ねぶ	舐
ねぼうき	箒
ねむ	眠
ねむのき	棔
ねら	狙
ねり	練
ねん	年念染捻粘然稔鮎燃撚冉唸娚拈苒赧黏軟縁緣
ねんご	懇諄
の	乃之埜野農廼膿箆儂孥及布希伸延於述典咽乗退納能飲載暢駕濃洩餐呑乘藏舒抻飮熨箟篦迺饒
のう	悩納能脳農濃嚢膿儂嫐惱曩檸瑙碯腦衲靹囊王生応呪苗皇耐翁應
のえ	辺
のお	直
のおく	奧
のが	逃遁佚迯逋遯
のき	軒檐
のぎ	穎頴
のく	溽辱奧
のくま	熊
のこ	鋸残遺殘
のこぎり	鋸
のこり	残殘
のごう	鄕
のごめ	釆
のし	師熨
のす	巢
のせ	瀨
のせき	關
のぞ	希除望窺臨覗莅覘
のぞみ	希
のたき	瀧
のたま	宣
のたむ	宣
のち	後肭
のっ	乗野乘
のっと	則
のとう	塔
のど	喉咽吭頏
ののし	罵詬
のはし	觜
のはま	濱
のび	燹
のびる	蒜
のぶ	允円収至亙亘寿伸延宜恒信宣修晋展経常進陳庸喜順敦業誠靖薫一夫史充房悦将倫惟啓寅登寛暢迪將圓頌
のぶる	暢
のべ	延
のぼ	上升昇登躋陞陟
のぼし	登
のぼり	登幟
のぼる	昂皐宣陟
のまき	巻
のみ	呑蚤飲御斐爾
のよ	與
のら	苗
のり	乃仁永功令礼考至孝利里宜尭宗昇法宣矩哲能倫教経理賀象智登統敦雅準慎禎徳儀糊賢議了孔文生仙式寿伯祈典紀研祝乗則律記訓師展規啓敬裕寛義稔暢範穂憲親謙織乘凖笵寬德
のろ	呪咒麕
のろう	呪
のろし	烽
のん	呑儂嫩音飲暖暢穏穩
は	刃巴羽把芭伯杷波派破歯琶葉頗端播覇簸坡怕霸爬碆笆耙菠袙陂齒羽八土万牙生半早吐芳欧果刷長映栄垣食穿華恥掃張婆晴脹貼飯番腫馳跳稲幡履繁爆麓捌填禿矧剥萬榮稻刄咯垪忸愧慙慚玻篏葩跛迸騁剝晴
はい	灰拝杯海盃背肺俳配排敗這菩廃榛輩牌狽蝿稗箆吠拜俾嬖孛廢徘悖擺沛湃珮琲睥碚篦胚蓖裴閇霈鞴入早妃貝走批孟派唄倍掃培陪閉賠罷誹佩旆癈
はいたか	鷂
はう	這
はえ	蝿生榛鮠
はか	博墓図伯計称経測量諏諮謀猷仭咨圖塋揆揣畧謨銓
はかど	捗
はかな	儚
はかま	袴
はかり	秤
はかりごと	猷謀揆畧
はがね	鋼
はき	吐履
はきもの	屐
はぎ	萩矧作剥骭剝
はぎゅ	萩
はく	白百伯拍泊迫柏舶博箔薄栢狛剥粕駁珀亳佰岶愽擘樸檗蘗璞膊薜陌駮剝朴縛覇爆簿帛搏魄
はぐ	逸
はぐき	矧齶
はぐく	育孚毓
はぐさ	莠
はげ	禿励烈激蒋勵
はこ	函箱笥箪運漕凾匣匳奩椢筺筥
はさ	久迫挟挿狹挾襭
はさま	生迫
はさみ	螯
はざ	迫廻挟狭挾陌
はざま	硲迫峡逧
はし	啄梁端箸橋走奔梯階趨犇赱
はしか	疹
はしけ	艀
はしご	梯
はしばみ	榛
はしゃ	燥
はしら	柱楹
はしり	走
はじ	恥垢初甫始創弾肇剏慙慚耻詬
はじかみ	薑
はじきざ	弾
はじめ	一大元甫孟紀哉啓肇始創弌俶
はす	芙蓉蓮荷泰斜
はすのね	藕
はず	筈外弾勢彈
はずかし	辱詬
はせ	支
はぜ	櫨鯊
はた	畑秦畠旗端幡機将傍叩幢旃旌旙礑籏
はたがしら	覇
はたけ	畑畠圃
はたさ	旗
はたす	毅
はたと	礑
はたはた	鰰
はたぼこ	纛
はたら	働
はだ	肌秦膚
はだか	裸
はだぎ	襦襯
はだし	跣
はだぬ	裼
はち	八椀鉢蜂捌溌釟醗甌
はちす	蓮
はちの	鉢
はっ	発醗發醱八白百初波服法薄
はっく	貊
はつ	八廿初発肇髪閥捌溌醗筏髮發秡罸釟魃伐抜泊服削般鉢罰撥觜潑
はて	崖涯垓
はと	鳩鴿
はとば	埠
はな	花華鼻英放塙話端縦離洟纐
はないき	嚊
はなし	話噺
はなだ	縹
はなぢ	衄
はなは	甚
はなぶさ	英
はなむけ	贐
はなれ	放離
はなわ	淵塙
はなん	花
はに	埴
はね	羽翰羽
はは	母媽
ははき	箒
はば	巾幅阻掵沮
はびこ	蔓
はふり	葬
はぶ	省畧
はべ	侍
はま	浜濱
はまぐり	蛤蚌
はますげ	莎
はも	鱧
はや	勇早速隼逸捷蚤囃湍駛鮠
はやい	夙斉
はやお	駿
はやし	林駿
はやせ	湍
はやぶさ	隼鶻
はら	原腹払妊拂姙禊禳秡肚襄
はらい	拂払祓
はらし	晴
はらみ	孕
はららご	鯡
はらわた	腸臓膓
はり	針梁榛播張晴貼畭
はりつけ	桀
はりゅ	針
はる	春晴榛元玄治青東明孟栄美原浩敏清問悠温朝遥陽暖靖榮遙夐迥溫
はるか	玄遼緬杳
はれ	晴
はれもの	腫癰
はん	反半氾犯弁帆汎坂阪伴判板版班畔般販斑飯番搬煩頒播幡範磐蕃繁藩叛釆扮旙汳泛潘燔笵繙胖膰蹣鈑鐇鷭繁飯凡返府漢榛盤翻絆拌攀槃樊瘢范袢
はんぞう	楾
はｎ	判
ば	芭馬婆場葉罵磨嘛瑪痲碼蟆陂刃化左羽伯芳波迫映峡発庭破張麻歯蕃摩魔塲旛發齒
ばあ	婆
ばい	売昧倍梅培陪媒買賠楳狽吠賣孛徘悖珮琲瑁眛薜裴霾鞴髀梅生灰毎貝杯枚背唄配陛埋排敗菩煤輩栂莓黴
ばえ	映蝿蠅
ばかま	袴
ばかり	秤
ばく	麦莫漠幕箔縛曝爆駁摸亳愽獏皃脉藐蟆袙貉貊貘陌麥白伯泊脈博貌膜暴薄簿寞瀑驀
ばくろ	伯
ばけ	化術
ばこ	箱函
ばさみ	鋏
ばし	啄橋箸矼
ばしら	柱
ばしり	走
ばす	蓮
ばせ	馳橋
ばた	畑俣畠旗端幡
ばたけ	畑畠
ばち	鉢罰罸魃抜蜂枹
ばっ	抜拔八末伐麦罰跋麥
ばった	蝗
ばつ	末伐抜沫罰閥筏拔罸襪靺韈魃抹祓跋
ばて	終
ばと	鳩
ばな	花華端鼻
ばなし	話噺咄
ばね	羽
ばば	婆糞
ばま	浜濱
ばみ	喰漿
ばや	早
ばやし	林
ばら	払服茨原散腹輩
ばらい	払拂
ばり	尿治針張鉤
ばる	春原
ばれ	晴
ばん	万伴判板挽娩晩番蛮蔓播盤磐蕃鰻絆萬卍悗旙縵胖蠻謾蹣鏝鷭晚半坂阪版畔般満搬慢漫繁礬蟠輓鑁
ぱ	波播羽派破歯頗端覇叭霸齒
ぱい	杯敗輩牌白拝盃肺俳配廃拜佩廢憊
ぱく	拍迫舶箔白伯泊博薄駁帛魄
ぱだか	裸
ぱち	八
ぱつ	髪髮発溌撥發潑
ぱま	浜濱
ぱら	原腹
ぱり	張
ぱる	春
ぱん	版般搬繁藩半犯帆判板販飯幡範
ひ	火日比皮氷灯妃否庇批彼披泌肥非枇卑飛毘疲秘被悲扉斐費琵碑緋鼻罷樋燈避轡匙匪誹僻箆祕俾嚊妣怫朏榧殍狒痞痺秕篦粃糒紕羆翡蓖譬貔豼賁陂霏鞁鞴髀鯡卑碑一干井引不曳冴似秀冷英沸退挽桧姫牽常陳理惹弾飯備陽遠簸婁彈檜丕冱冰婢屁拏掎暃曵杼梭涸砒脾腓蜚裨鄙
ひい	秀贔
ひいな	雛
ひいら	柊
ひいらぎ	柊
ひうち	燧
ひえ	稗冷肥
ひか	光晃控熙扣熈爍
ひかえ	控
ひかがみ	膕
ひかり	光耀晶曜
ひかる	輝光
ひが	僻
ひがい	鰉
ひがし	東
ひき	匹疋曳挽逼皀引将率碾蟇蟆
ひく	曳低
ひぐま	羆
ひぐらし	蜩
ひけ	引
ひげ	須髭髪鬚
ひこ	彦光州勉
ひこき	彦
ひこばえ	蘖
ひご	籖
ひさ	永玖尚恒宣桐剛久之央史仙宏寿弥教悠粥壽鬻
ひさぎ	楸
ひさご	瓢匏瓠蠡
ひさし	永寿庇尚弥恒亀九亘廂廡檐簷
ひさめ	霈
ひざ	膝
ひし	菱蔆
ひしお	醤醢
ひしくい	鴻
ひしひし	犇
ひしめ	犇
ひしゃく	杓
ひじ	土肘肱一泥
ひじき	枅
ひじり	聖
ひず	歪
ひそ	久私窃秘密潜潛濳顰
ひた	直浸淫常
ひたい	額
ひたき	鶲
ひたし	浸
ひだ	摺襞
ひだり	左
ひち	疋畢篳蹕七匹必筆
ひちくど	諄
ひっ	匹引必畢筆逼
ひっさ	挈
ひつ	匹疋必泌畢筆弼逼篳蹕払匱櫃謐
ひつぎ	棺
ひつぎぐるま	轜
ひつじ	未羊
ひつじさる	坤
ひつじざる	坤
ひづめ	蹄
ひで	任秀栄嗣豪一英茂康偉榮
ひでし	秀
ひでり	旱
ひと	一人史士仁民匡斉独特智等準齊弌獨鈞
ひとえ	単單襌褝
ひとし	一仁均倫斎欽整斉
ひとつ	一壱弌
ひとみ	瞳
ひともし	鐙
ひとや	牢圄圉
ひとり	独孑獨
ひとりもの	煢
ひど	酷
ひな	雛
ひね	捻撚拈
ひねく	弄
ひの	桧檜
ひのえ	丙
ひのき	桧檜
ひのくち	閘
ひのし	熨
ひのと	丁
ひひ	狒
ひび	響皴皸皹響
ひびき	響韵
ひぼ	誹
ひま	暇隙閑遑釁
ひむし	蛾
ひめ	姫媛姬
ひも	紐綬
ひもと	繙
ひもの	鱶
ひもろぎ	胙膰
ひゃく	百拍柏碧栢僻佰岶擘檗蘗薜襞躄霹伯泊迫壁癖覇
ひゃっ	百
ひゃん	香
ひや	冷
ひゅう	彪
ひゅく	百
ひょう	氷丙平亨兵表俵豹浜彪票評漂標瓢杓冰凭娉嫖并怦慓憑枋枹殍泙澎炳皰磅秉迸飃飆驃髱鰾麭包拍併泡柄胞秤砲飽餅爆烹剽雹飄馮
ひょうしぎ	柝
ひょく	逼愎皀
ひよこ	雛
ひよどり	鵯
ひら	平拓波枚挨啓開衡拆擺攤豁
ひらめ	閃鮃
ひる	昼蒜蛭晝怯
ひるがえ	翻翩飃
ひれ	鰭
ひろ	仁宗拓弥紀彦宥紘泰展容倫郭啓尋博普裕聖緩寬十大之凡公央玄広弘氾宇汎宏伯英拡官幸周宙典門恢拾祐洋晃浩恕祥敬陽遠寛蓉廣熙丕敞汪瀚煕熈碵胖濶
ひろあ	浩
ひろい	拾
ひろし	大弘礼汎宏祐浩紘裕豊宇寛
ひろひ	遠
ひろむ	弘
ひろめる	拡める
ひろん	寛
ひわ	鶸
ひん	品浜彬貧賓頻瀕斌牝梹檳濱秉禀繽蘋顰鬢賓頻行擯殯
び	火皮未尾枇弥毘眉美孫梶備琵微鼻媚嵋弭殍濔狒痞糒糜紕縻貔豼鞁鞴麋靡日比妃否披肥味疲被桧敏魚斐傍陽碑罷樋魅避檜寐瀰
びい	贔
びう	為爲
びかえ	控
びかり	光
びき	曳愎引疋挽弾彈曵
びこ	彦
びさし	庇
びし	菱
びしお	醤醬
びた	鐚
びたい	額
びち	弼払泌
びっ	備
びつ	蜜樒櫁密櫃
びと	人
びな	雛
びゃく	白佰擘甓百舶闢
びゃっ	白
びゅう	謬繆
びょう	平庄妙苗秒病猫描鞄廟瓢錨鋲凭匏屏弸杪殍泙渺皰眇緲苹藐蚫靤飃驃鮃鰾屛兵坪拍並瓶棚評膨庖
びら	平
びる	蒜
びれ	鰭
びろ	広廣
びん	便秤敏貧瓶岷旻梹檳泯緡罠蘋顰鬢敏甁備賓頻牝壜愍憫紊罎閔
びん(表外)	民
ぴ	扉日比皮妃否庇肥非卑飛毘秘被費碑樋祕臂鄙
ぴき	匹
ぴこ	彦
ぴつ	泌筆
ぴゃく	百
ぴょう	憑氷平拍表票評標瓢
ぴょん	平
ぴら	平
ぴる	昼晝
ぴん	品稟嬪萍
ふ	不夫父生付布扶芙甫府怖斧附負赴釜浮圃峯婦冨符部副斑富普腐輔敷膚賦撫鋒覆譜埠鮒鋪訃仆俛俯咐坿孚孵拊枹柎殍殕烽畉痞脯舖艀苻蜉賻趺逋郛釡餔鯆鳧鳬麩麸黼二文缶伏老更吹否阜歩臥拭風浦降振峰剖深船捧殖葺雰補蒲触践福蜂豊増踏噴舗嘘嬰巫俘偃傅桴溥腑觝觸蹂蹈躔躡步增
ふぃ	菲
ふぃーと	呎
ふい	吹
ふいご	鞴
ふう	二不阜封風冨幅楓鋒枹泛烽痞瘋罘艀蜉夫缶否服負浮婦副菩富復蜂覆諷
ふぇい	菲
ふえ	笛簫籥鰾
ふか	作深泓鱶
ふき	葺蕗𧘱袘吹苳
ふく	伏服副復幅福腹複覆愎箙茯蔔蝠蝮輹鞴鰒福含吹脹膨匐袱輻馥
ふくべ	瓢
ふくろ	袋嚢
ふぐ	鮭鰒
ふけ	吹耽酖
ふげ	鳳
ふご	畚
ふさ	房亮惣総角杜妬梗塞欝填堙壅總閼阨
ふし	節節伏椹樶
ふじ	藤二籘
ふじゅ	藤
ふす	熏
ふすま	襖麸
ふせ	伏防臥禦扞捍
ふた	二双蓋雙弐両弍兩盖葢貮
ふたお	蓋
ふたた	再弍
ふたたび	再
ふだ	札牒牌槧
ふち	淵禄縁緣眉祿渕潯
ふちど	縁
ふっ	沸復払伏風副富福腹覆弗拂
ふつ	不仏払沸弗拂彿怫髴黻佛
ふで	筆翰
ふと	太肥
ふとおび	紳
ふところ	懐懷
ふな	鮒舟船舩
ふなばた	舷
ふなべり	舷
ふにゅ	舟
ふね	舟船舶槽舩舸艘
ふひと	史
ふびと	史
ふまき	帙
ふみ	文郁踏翰冊史邦典章詞册
ふむと	梺
ふもと	麓梺
ふゆ	生冬
ふらん	鞦
ふり	降振
ふる	旧古降振揮震奮篩顫
ふるざけ	酋
ふれ	触觸
ふん	分吻粉紛焚雰噴墳憤奮扮糞枌氛濆芬賁頒刎吩忿
ふんどし	褌襠
ふー	胡
ぶ	不父分芙阜侮武歩釜峯逢部葡無蒲腐輔蓬鳳撫舞蕪蔀埠鮒鵡咐嘸坿廡抔枹畉篷罘脯艀苻蜉賻釡錻鞴鳧鳬鵐鶩步侮亡夫仏生打布扶府附服奉負風振浮捕俸峰培婦符菩務普復豊賦穂縫覆簿霧佛穗憮誣麩
ぶう	鳳封
ぶえ	笛
ぶか	深
ぶき	吹葺噴
ぶく	箙茯鞴鰒伏服袋復福
ぶくろ	袋
ぶさ	房
ぶし	伏節
ぶす	毒
ぶすき	宿
ぶすま	衾
ぶせ	伏臥
ぶせり	伏
ぶた	豚二蓋
ぶち	淵駁渕縁駮緣
ぶっ	仏物佛
ぶつ	仏勿物佛忽
ぶと	太蚋
ぶところ	懐懷
ぶどう	萄
ぶな	椈橅桕
ぶね	舟船槽
ぶまさ	昌
ぶみ	文
ぶゆ	蚋
ぶよ	蚋
ぶり	風振鰤
ぶりき	錻
ぶん	分文吻聞枌氛汾濆賁馼蚊紋問焚頒墳憤
ぷ	符賦夫父付布否府斧附釜峰婦富腐膚譜鮒腑麩
ぷう	封風
ぷく	伏服復幅福腹複覆
ぷん	分吻粉紛憤奮糞
へ	巴芭盃部怕擺湃笆袙戸日圧平辺妃把伯兵拝杯派背配経敗閉減輩蔽覇剥屁經舳邊
へい	丙平兵併並柄陛閉塀幣弊蔽餅箆俾娉嬖幤并敝枋泙炳睥秉竝篦聘苹蓖薜袂閇髀鮃倂塀批坪恵病瓶評屏斃屛甁
へき	碧壁癖僻璧擘甓襞躄霹又劈辟
へぎ	枌
へくとぐらむ	瓸
へくとめーとる	粨
へくとりっとる	竡
へこ	凹
へさき	艫舮
へず	剥
へた	蒂蔕
へだ	距隔
へち	暼瞥
へっつい	竃
へつ	暼別瞥
へつら	諂
へな	埴
へび	巳蛇它
へや	室曹
へら	箆篦
へり	縁緣
へりくだ	遜謙
へん	片辺弁返変偏遍篇編鞭辧卞扁變汳翩胼蝙褊諚諞貶邊鈑騙板版便班般逸斑頒扮邉
べ	戸辺杷部琶牌稗幤敝耙裴邊邉甁可弁缶米兵背唄俳倍排培陪瓶賠罷弊頭辯
べい	皿米餅袂平迷塀幣謎
べき	糸幎汨羃覓壁冪
べち	別淵
べっ	別戸蔑瞥鼈
べつ	別蔑瞥襪韈滅
べに	紅朱
べの	倍
べら	平
べん	弁阪便面勉娩眠麺鞭釆棉緬俛冕辧卞抃汳泯湎緜胼諞謾辯麪勉坂免偏綿辨眄辮駢
ぺ	北瓶
ぺい	北併蔽倂平兵病閉餅
ぺき	碧璧壁癖
ぺん	片平辺変遍篇編變邊
ぺーじ	頁
ほ	帆甫歩宝保圃捕部菩葡補報蒲輔舗穂燈埠鋪呆哺穗咐寳畆脯舖菠葆褓逋鞴餔鯆黼步干火父布灯秀芳怖武法胡侯肺浦畝峰掘惚彫婆欲湖廃普蜂豊誉緒賞褒譜簿讃吠慾頌匍埔堡寶苹豐鎬鐫雕
ほい	穂焙
ほう	方包庄亨芳邦奉宝抱放朋法泡封風保胞豹倣俸峰峯砲逢部崩捧萌訪報楓蜂豊飽鞄蓬鳳褒鋒縫鵬蔀鴇呆庖烹萠匏咆垉堋寶寳弸彷怦抔枋枹殕泛泙滂澎烽琺疱瘋皰磅篷罔膀舫葆蚌蚫褓襃豐迸靤髣髱魴麭乏毛北朴判坊妨防房肪胡祝浜剖紡培喰棚傍棒暴膨爆幇彭抛硼繃鉋鮑
ほうき	荘彗帚箒菷
ほうの	朴
ほうむ	葬
ほお	頬頰朴
ほおつき	面
ほか	外他
ほが	朗朖朗
ほがらか	朗
ほき	洞
ほぎ	祝
ほく	卜北僕曝仆樸殕濮璞蔔蹼駮朴菩暴撲爆剥駁
ほくそ	樮
ほくろ	痣黶
ほぐ	解
ほこ	矛戟鉾架誇戛戞桙槊釶
ほこさき	鋒
ほころ	綻
ほご	夸
ほさき	穎頴
ほし	星干乾
ほしい	糒
ほしいい	糒
ほしいまま	縦亶
ほじ	穿
ほじし	脯膊
ほず	穂穗
ほそ	細
ほそいと	緬
ほた	榾
ほたる	蛍螢
ほたるが	蛍螢
ほち	不弗彿髴黻払発髪
ほっ	北払法星発堀欲拂發
ほつ	発勃孛悖發払解
ほづ	秀
ほと	辺程
ほとぎ	缶甌罌
ほとけ	仏佛
ほとばし	迸
ほとほと	殆
ほとぼ	熱
ほとり	阿瀕上畔濆陲
ほとん	殆
ほど	程解觧
ほどこ	施
ほね	骨
ほのお	炎焔
ほばしら	檣艢
ほふ	屠
ほほ	頬
ほぼ	粗畧
ほま	誉譽
ほまれ	誉
ほむら	焔
ほめ	称誉
ほら	洞
ほらが	洞
ほり	堀壕濠掘彫隍
ほろ	幌亡微滅泯袰
ほろぼ	殱
ほん	本阪奔品幡翻飜悗旙汳泛濆犇畚笨繙賁反氾汎坂返洪香盆販番誉蕃噴墳藩叛譽
ぼ	戊母牡姥莫菩募墓慕暮模簿摸媽糢謨応歩保圃惚彫帽鳳膜穂褒呆應穗姆拇襃步
ぼう	亡乏毛卯戊母忙牟妄牡坊妨忘防茅朋房肪孟胞某冒剖紡猫萌望傍帽棒貿蒙貌暴膨謀鵬虻呆鉾萠儚夘堋梦尨彷惘懋旄曚桙楙榜檬氓滂濛瑁甍畆皃矇罔冐膀艨茆蚌蠎蟒袤謗髦魍魴鴾方包矛奉宝抱法茂保畝峰訪猛棚夢網吠頬眸厖寶旁芒茫蒡鋩頰
ぼうき	箒
ぼうの	坊
ぼえ	吠
ぼか	暈
ぼく	卜木朴牧睦僕墨撲穆仆樸樢殕濮璞繆冐苜蔔蹼鶩墨北目冒菩暴黙曝
ぼくのと	卜
ぼこ	鉾凹
ぼこり	埃
ぼし	干星
ぼそ	細
ぼたん	釦鈕
ぼち	勃閥孛怫悖罸伐筏
ぼっ	勃坊没牧墨渤
ぼつ	没勃孛悖沒歿
ぼとけ	仏佛
ぼね	骨
ぼまい	舞
ぼら	洞鯔鰡
ぼり	堀掘彫濠
ぼれ	耄
ぼろ	幌襤
ぼん	凡盆悗捫梵樊燔笵笨膰鐇鷭犯本帆門飯番煩範蕃墳繁悶
ぽ	歩舗步甫宝保畝婆補暮穂哺穗寶
ぽう	包泡俸砲烹方邦奉宝放法封保胞峰報豊鳳鋒寶炮豐
ぽく	北袱
ぽろ	幌
ぽん	椪本先奔
ぽんど	听磅
ま	真麻間摩磨魔茉眞莉嘛痲蟆又丸士万勾正未目曲交先松放巻待美負益孫馬捲黒混畳須番満愛雅蒔慎熊雑増撒播幡舞麗纏撹駁卷萬愼疊俟滿糅襍黑增
まい	米毎妹枚昧埋舞舛剃楳瑁眛莓袂邁霾每売参牧迷梅媒詣蒔鞠謎賣參
まいあし	舛
まいくろめーとる	粆
まいくろりっとる	竗
まいな	賂
まいない	賂
まいる	哩
まえ	前
まか	蒔任委罷
まかな	賄
まが	勾曲紛禍擬
まがき	樊籬
まがた	曲
まがり	勾曲鈎
まき	牧巻蒔槙卷槇撒薪填塡
まきの	牧
まぎ	紛
まく	莫幕膜摸皃藐捲漠貌
まくら	枕
まくらの	枕
まぐさ	蒭
まぐろ	鮪
まげ	髷
まげもの	椦
まこ	誠
まこと	丹実亮真淳惇慎誠諒一允良信胆理賢諦寔忱恂愨
まことに	涼諒
まこも	菰蒋
まご	孫
まごころ	悃
まさ	允方正匡庄存尚昌和柾祐剛将容晶雅幹聖誠暢諒賢元公仁充当芳宗征斉直明栄祇政祥真泰倭理順勝善傑慎稚優愈眞將愼榮齊橸
まさか	作
まさかり	戉鉞
まさき	柾
まさし	仁匡昌雅一理奨
まさに	応
まさめ	柾
まさる	大賢克冠超豪
まし	況益猿増况增
ましま	坐
ましら	猿
まじ	交参雑襍
まじな	呪咒
まじない	咒
ます	升松倍鱒舛桝斗政祐益増賢枡增
ますます	益
ますら	丈
まず	貧
ませ	柵
また	又也亦股俣叉全岐街復跨椏胯
またた	瞬
まだら	斑駁班駮
まだらうし	犖
まだらうま	騨
まち	町沫街靺末抹待都襠陌
まっ	抹末松茨真摩眞
まった	全完
まっと	完
まつ	末松抹沫靺茨待黒祭祷雅纏茉枩枌秣竢纒黑
まつげ	睫
まつも	黒黑
まつり	祭
まつりごと	政
まて	蟶
まで	迄
まと	的鵠本洛絡纏纒
まとう	綢
まど	窓円惑圓窗
まどか	円
まどの	円圓
まな	学真愛眞俎學斈
まないた	爼
まなこ	眼
まなびや	庠
まにま	随
まぬか	免免
まぬが	免
まね	招
まの	馬
まば	稀疏疎踈
まばた	瞬
まぶた	瞼
まぼろし	幻
まま	侭畑飯継儘圸墹壗繼
まみ	塗狸猯覲逅遘
まむし	蝮
まめ	豆荳菽
まも	守護
まもり	守
まもる	葵衛
まや	厩
まゆ	眉繭誠
まゆみ	檀
まよ	迷
まよい	迷
まら	厩
まり	球鞠丸余宣毬餘
まる	丸円団圓圜摶
まるい	肱
まれ	稀希罕
まろ	理麿円転
まろうど	客
まわ	回周廻囘
まわし	廻
まわり	廻
まを	緒緖
まん	万満慢漫蔓幡鰻萬卍曼悗滿縵謾蹣鏝饅茂孟茨真馬敏娩眞幔懣瞞鬘
まんじ	卍
まー	麻
み	三巳壬水未身実味弥美珠梶深聖箕毅魅臨實嵋弭濔糜縻麋己子生民光耳充妃位芥見臣男尾利海看皇泉眉恵造規現視蛇都務御診満溢幹塞瑞農微爾蜜銘監薬績覧観鏡盈已惠彌藥滿漿睥睹瞿瞻矚覩觀
みう	苗
みうち	戚門
みうり	賣
みえ	恵惠
みか	甕
みかづき	朏
みかど	帝
みかん	柑
みが	砥琢瑳磨砺
みがき	磨
みき	幹寸樹
みぎ	右
みぎり	砌
みぎわ	汀
みくじ	籤
みこ	覡
みこと	命尊
みことのり	詔勅
みごも	妊姙
みさ	操
みさお	操
みさき	岬碕埼岫
みさご	鶚
みささぎ	陵
みじ	惨慘
みじか	短
みす	簾
みず	水瑞端
みずうみ	湖
みずか	自
みずかき	蹼
みずたで	薔
みずたまり	瀦
みずち	鮫
みずのえ	壬
みずもり	準凖
みずら	髻鬟
みせ	店鋪廛
みそか	晦
みそぎ	禊
みそっぱ	齔
みそなわ	臠
みぞ	溝涜渠洫
みぞれ	霙
みたまや	廟寝
みだ	冗妄乱淫漫濫撹擾亂婬溷紜
みだら	姦
みだり	叨
みだれ	乱亂
みち	至充亨芳享紀通倫康理陸道満蜜慶樒櫁往径典弥信途密庸達裕路暢迪廸徃徑滿甼衢逕陌隧
みちのり	里
みちび	導廸
みっ	三密
みつ	三允円充足苗弥晃密満舜慎瑞蜜盈樒櫁水弘光臣参実貢暢實滿肆
みつぎ	貢
みつる	満暢
みつろう	蝋
みづ	水瑞
みと	認
みとめ	認
みどり	翠碧緑綠翆
みどりご	嬰
みな	皆凡水汎波南僉
みなぎ	漲
みなと	港湊
みなみ	南陽波
みなもと	源
みなもとの	源
みにく	亜醜
みね	峰峯嶺岑岫崟嶂
みの	蓑箕耳実稔實簑簔
みのり	稔
みのる	豊稔聡穣穰
みはり	哨
みみ	耳
みみざと	聡
みみしい	聾
みみず	蚓蚯
みみだま	珥
みみなぐさ	苓
みめよ	娥
みゃく	脈幎汨獏羃脉袙覓貉貊貘陌糸麦
みや	宮雅
みやこ	京都畿都亰
みやこがえ	遷
みやこの	都
みやび	嫺嫻
みゅう	謬繆
みゆき	幸
みょう	卯名妙茅苗命明孟秒冥猫鳴廟虻錨萠夘暝杪榠氓渺溟甍皃眇緲茆茗藐螟酩皿盲描萌盟貌銘
みり	粍
みりぐらむ	瓱
みりめーとる	粍
みりりっとる	竓
みわ	神
みん	民眠岷旻泯緡罠三水明敏
みんな	皆
む	六矛牟武務陸無睦夢撫蕪霧鉾鵡嘸梦廡懋曚桙楙檬濛畆矇艨袤鴾鵐鶩亡生戊母向虫牡麦侮茂某院珠畝浮産望貿群蒸蒙暮慶舞謀剥噎烝羣蟲
むい	六
むか	向迎対逢
むかい	向
むかえ	迎
むかえる	這
むかし	昔
むかばき	逼
むき	向
むぎ	麦麥
むぎこ	麺麪
むく	椋向報酬讐讎
むくいぬ	尨
むくげ	椴槿毳葮蕣
むくの	椋
むくろ	躯骸
むぐら	葎
むけ	向
むこ	婿壻聟
むこう	向
むご	惨
むさぼ	毎昧慾貪婪餮饕
むし	虫蟲蒸寧毟
むしあつ	溽
むしば	蝕齲
むしろ	席筵莚蓆
むじ	芝
むじな	狸狢貉
むす	掬結
むすび	結
むすめ	女娘嬢
むずか	難難
むせ	咽哽噎饐
むだ	徒
むち	鞭笞
むちう	鞭捶
むっ	六
むつ	六陸睦
むつか	難
むつき	繦褓襁
むつゆび	跂
むな	空宗皆胸虚棟昿
むね	旨胸棟統睦宗順義臆
むひょん	賢
むよん	蓮
むら	村邑邸党群叢簇羣邨
むらがる	群
むらさき	紫
むらじ	連
むりだけ	嶽
むれ	群羣
むれる	群
むろ	室榁
め	女目芽眼雌罵楳嘛瑪痲碼莓蟆霾召布米売妻枚明免馬梅姫埋麻買愛滅銘瞳牝
めあわ	娶
めい	名命明迷姪冥盟銘鳴謎暝榠溟瞑螟酩皿梅茗
めいの	姪
めおと	娚
めかけ	妾
めき	笑
めく	捲
めくら	盲瞎
めぐ	回巡芽廻恵斡寵匝惠圜徼恤遶
めぐみ	恵み恩慈潤
めぐむ	萠
めぐり	廻
めぐる	桓
めし	飯飯召瞽矇
めじり	眥眦
めす	雌牝
めずら	奇珍竒瑰
めち	蔑滅
めっ	滅
めっき	鍍
めつ	滅
めと	娶
めどぎ	筴蓍
めばえ	萌萠
めばる	鮴
めまい	暈
めん	免面娩眠綿麺牝棉緬俛冕泯湎粫緜縵麪免麵妻明勉蛮雌慢
めーとる	米
も	母茂姥莫雲喪裳模藻摸媽懋楙畆糢袤謨文毛右守百牡若宙妹抹門持美某面真畝馬盛添萌望最募貿無墓慕暮膜漏輪燃洩溌眞萠儻麼揉
もい	萌門
もう	毛妄孟盲耗望猛蒙網虻萠儚尨惘旄曚檬氓濛瑁甍矇冐艨蠎蟒髦魍亡申生白忙忘冒設萌帽詣儲朦莽
もうし	申
もうで	詣
もえ	萌燃
もく	木目睦黙穆杢默樢繆冐鶩牧冒墨沐
もぐ	潜潛濳
もぐさ	艾
もじ	綟
もすそ	裳裙
もず	鴃鵙
もた	凭擡抬齎靠
もたい	瓮罌
もだ	黙悶
もち	勿物餅沒襪韈才以用没茂持望須餌黐
もちあそ	玩
もちあわ	朮
もちい	餅
もちごめ	糯
もちのき	橿
もっ	木勿以目没牧黙默
もっけ	牧
もっこ	畚簣
もって	将
もっと	尤最
もっぱ	専醇專
もつ	物沒没縺
もて	茂
もてあそ	弄玩
もてあぞ	翫
もてな	饗
もと	下大元台本紀素基智幹職一旧玄亙亘求固宗故要許産順須源資誠質礎夲很悖愎狠覓
もとい	紀基統
もとお	廻
もとどり	髻
もとむ	須
もど	戻擬戾
もどし	戻戾
もどり	戻
もぬ	蛻
もの	者物者茂桃
ものいみ	斎
ものう	嬾慵
もみ	籾粟樅
もみじ	椛栴
もむ	蟐
もも	股桃腿百髀
もや	霏靄
もよお	催
もよおし	催
もら	貰
もり	杜森衛守茂盛敬護銛
もろ	艶一両室師諸脆萬兩
もろみ	醪
もろもろ	諸烝
もん	万文門紋問聞蔓鰻悶卍捫馼吻郎蚊挽晩衛衞們
もんど	百
もんめ	匁
もーら	拍
や	八也矢冶夜弥屋哉耶家埜野箭爺彌呀揶鵺日乎生宅灼谷岩舎邪亭柳悦射泰病魚斜焼痩焚陽雅遣辞寝綾爾罷養薬露椰燒藥弭歟煬燔燬疚瘠輟辭瘦
やあど	碼
やある	碼
やい	柳焼燒
やいと	灸
やいば	刃刄
やお	八
やかい	輩
やかた	館舘館
やかま	喧
やから	族属輩
やが	軅
やがて	軈
やき	燒咲焼
やきがり	焚
やぎ	柳焼燒
やぎゅ	柳
やく	厄亦役約訳駅薬躍唖藥奕懌籥葯蜴蝪譯鑰阨鯣易疫益射液扼軛益
やくしょ	庁廨廰
やぐら	櫓
やけ	宅宿焼燒
やさ	易優
やしき	邸廛
やしな	食飼養飴豢
やしろ	社廟社
やじ	雅
やじり	鏑
やす	考那芳坦和彦宴恭恵祥秦泰悌烈健康庸裕鳩寧慶仁安休匡寿妥易育奉保倭靖嘉徳輔賎綏雍德
やすし	欣恭泰悌康靖寧純健
やすみ	休
やすり	鑢
やすん	息
やず	和
やせ	憔
やち	萢
やっ	厄八約薬躍藥
やっこ	奴
やつ	八奴勉扮悴忰憔窶
やつがれ	僕
やと	雇傭
やとい	雇
やど	宿舎舍
やどり	宿
やな	柵梁柳棚簗
やない	柳
やなぎ	柳楊
やに	谷脂
やはず	筈
やぶ	薮破敗壊敝籔藪
やま	山日岾疚
やまい	病
やまいぬ	犲
やまぐわ	柘
やまず	斗
やまと	倭
やまどり	翰
やまなし	杜
やまにれ	梗
やまのかたち	嶐
やみ	闇
やむ	飲
やもお	鰥
やもめ	寡孀鰥
やや	良稍
やらい	柵
やり	槍鎗鑓遣
やわ	和柔軟凱輯穆廱
やわら	燮
やん	陽賢壌壤
やんす	樹
やんほ	鎬
やーど	碼
やーる	碼
ゆ	由佑油勇柚唯悠湯愉猶裕諭輸癒愈喩釉壅廱慂揄攸渝犹瘉腴莠萸蕕蚰蛹蝓蝣覦踰踴逾弓之夕友弘世生宇行百有酉往幸宙祐逝温結遊雄揺楢誘踊憂融擁優涌猷搖兪徃瑜臾茹諛溫
ゆい	惟唯瞶由結維遺
ゆう	夕友右由幼有酉佑邑勇宥幽柚祐悠郵湧猶裕遊雄楢蓉輔誘憂融優揖涌猷熔釉俑囿悒慂攸犹甬癰肬莠蕕蚰蛹蝣踴鎔黝又尤用泣油郁柳容庸結湯愉溶熊踊諭曜侑游
ゆうめし	餔
ゆえ	故
ゆか	床弘
ゆかり	紫縁
ゆが	歪咼
ゆがけ	夬
ゆき	之如亨走享幸恭将晋雪順維徳千介元世由行至孝志征門紀祥展透章喜敬潔侑于裄靫
ゆく	雲行
ゆす	梼濯檮
ゆず	柚禅遜譲讓
ゆずり	譲讓棡
ゆずりは	杠
ゆた	寛豊豐
ゆたか	宥浩泰裕豊穣寛穰胖豐
ゆだ	委
ゆだめ	弼檠
ゆの	柚湯
ゆはず	弭
ゆばり	尿
ゆび	指
ゆまり	尿
ゆみ	弓弦
ゆめ	夢梦
ゆり	里梨岼閖
ゆる	万允弛宥恕許赦釈寛緩縦聴萬綽
ゆるが	忽
ゆろこぶ	台
ゆわい	祝弱
ゆわまる	弱
ゆわる	弱
ゆん	弓俊
よ	与予乎四世生代余於夜誉預傭輿與豫唹歟淤畭舁蕷蜍譽餘八可由因吉自百米寿芳良依拠呼美訓除宵能寄啓酔詠寓善蓉榎嘉読誼避撚壽醉仍凭丗搓綯縒譱臧讀酊酩醺隱靠饒
よい	宵生良酔醉
よう	幼用羊妖英栄洋要容庸瑛湧揚揺葉遥陽腰傭楊溶蓉暢様踊窯養鴨擁謡曜耀嬰盈穎頴厭鴬銚蝿涌熔搖瘍遙樣謠佯俑咏嚶塋壅姚廱徭怏慂慵拗杳昜暘曄楹楪殀殃泱潁瀁瀛煬珱甬癢癰秧穃窈窰纓罌蛹蠑贏踴郢鎔閘霙靨魘鴦鷂八圧永凹央応沃泳押映約勇桜祥菜陶営詠景雄領影鷹瑶燿夭榕漾瓔痒膺邀瑤
ようやく	稍
よく	抑沃浴欲翌臆翼慾峪杙檍翊域億憶弋
よけ	除
よこ	横橫
よこいと	緯
よこぎ	軫
よこしま	邪咼佞侫慝
よご	汚
よし	允仁巧由吉圭考至如芦快孝甫芳佳宜欣幸叔昌和栄紀宣洗彦祐亮悦恭桂純祥泰悌哲能啓淑彬理賀喜欽禄義慈禎睦徳儀慶膳艶麗巌孔兄功正礼好次充芹克寿秀男良宗斉忠香美益恵剛惟斎貴敬順勝善愛雅詳靖嘉寧領誼薫憲賢縦脩惠壽榮齊禮悳齋譱葭蘆德
よしみ	誼媾
よしも	謙
よすが	縁
よせ	寄
よそ	比
よそお	装扮裝妝
よち	頼
よっ	四浴欲
よつ	四
よつぎ	胄
よど	生淀澱
よな	米沙淘涛
よなげる	汰
よね	米
よねど	粐
よば	呼
よび	呼
よびな	号
よぶ	呼
よぼる	伸
よみ	詠嘉読讀
よみがえ	蘇
よむ	詠
よめ	嫁娵
よも	智
よもぎ	蓬艾蒿蕭
よゆ	洋
より	依和賀因米委於拠従寄閑順緑頼據綠賴
よる	夜
よろ	宜寄鎧
よろい	鎧
よろこ	欣悦喜歓慶僖忻憙懌懽熈驩
よろず	万萬
よわ	弱嬬孱羸
よわい	脆歯齢
よん	四英
よんすう	秀
ら	裸螺羅拉瘰蘿蠡鑼十乱良浦倉浪晶税等楽彰蘭篭樂籠薇邏騾
らい	礼来雷頼蛎莱來蕾禮儡唳櫑犂犁瘰癘綟罍藜藾蠡賚醴隸驪鱧萊賴戻励隷瀬麗徠癩磊籟
らう	劉
らき	滝
らく	洛掠略絡落楽酪樂咯擽烙犖珞畧駱格
らち	糲埒埓
らっ	落楽辣樂喇
らっきょ	辣
らっきょう	薤
らつ	辣溂糲剌埒埓
らの	蔵藏
らら	晶
らん	乱卵嵐覧濫藍蘭欄覽亂儖婪嬾欒欖瀾爛繿臉襤鑾闌鸞欄浪巒懶攬籃纜襴
らー	辣
り	吏利李里浬哩梨理痢裡裏履璃鯉離狸俐莉罹犂犁莅蜊蠡貍釐驪乃切伐取垂林美厘荷降寄鈴麗俚悧漓詈
りぃ	里
りい	利
りえ	江
りき	力篥
りく	六陸勠戮淕
りご	篭籠
りそ	磯
りち	葎篥律栗率
りっ	栗六立律陸
りっとる	立
りつ	立律栗率葎慄篥
りほ	庵
りゃお	遼
りゃく	掠略擽櫪畧癧轣靂暦歴曆
りゃっ	略
りゅう	柳流留竜笠琉粒隆硫溜劉龍嚠嶐摎澑瀏璢畄窿繆苙鉚鏐隴霤餾鰡隆生立滝瑠瀧旒榴毓瘤
りょ	侶旅虜慮廬櫚臚鑢閭虜呂涼膂
りょう	了両良伶怜亮玲凌料菱掠梁涼猟陵椋量稜綾漁僚領寮諒遼霊龍療瞭嶺糧苓崚羚兩喨囹崢廖暸櫺獵粱粮繚聆蔆薐蛉裲踉輛輌鍄隴靈鬣魎鴒鷯永令杏冷貞竜鈴零齢凉燎倆寥撩楞聊鐐
りょく	力緑綠録
りん	林厘倫淋琳鈴綾輪隣臨鱗麟燐凛凜侖廩懍棆痳禀菻薐躪鄰珠梨稟綸吝悋淪醂釐霖
りんしょ	吝
りー	里
る	琉硫溜瑠劉魯蕗櫓鷺屡婁篭聾僂哢嚠嶐廬摎滷澑瀏瀘璢畄窶窿簍繆艫舮蘢褸輅轤鉚鏤鑪鈩霤顱餾髏鰡鱸芦弄炉昼柳流留隆塁虜賂路楼漏露櫨盧縷
るい	涙累塁類壘瘰縲羸誄淚類
るう	槞
るうぶる	留
るつぼ	堝
るり	璢
るを	郎雄郞
れ	伶玲砺糲令礼余例連禮餘
れい	令礼戻伶冷励例怜玲鈴零霊隷嶺齢麗蛎砺苓羚黎禮勵唳囹櫺犂犁癘糲綟聆藜蛉蠡醴隸靈驪鱧鴒齡戾祈黄領澪儷茘
れき	暦歴櫪癧轣靂曆歷瀝礫轢
れち	列洌劣烈裂
れっ	列劣裂烈
れつ	列劣烈裂洌律冽唳
れん	怜恋連廉煉蓮漣練憐錬簾聯匳嗹奩戀楝櫺歛濂瀲縺聨臉臠鏈鰊練鍊鎌攣斂輦
れんじ	櫺
ろ	芦呂炉侶幌賂路魯蕗櫓露鷺櫨婁廬櫚滷濾瀘爐臚艫舮輅轤鑢鑪鈩閭顱髏鱸沪二老郎納旅朗浪禄楽虜慮論篭蝋樂籠枦梠盧絽艪蘆閇驢鹵郞蠟
ろう	老良労弄亮郎朗浪狼掠梁廊稜楼摺漏龍瀧婁榔牢篭聾蝋籠僂勞咾哢喨朖柆槞樓潦琅瑯癆窶簍粱粮莨薐蘢螂裲褸踉醪鏤鑞隴髏魎郞朗廊蠟桜竜涼椋量滝諒糧露櫻壟撈朧瓏瘻臘臈陋鵞
ろうそく	蝋
ろお	郎
ろく	六肋鹿禄録麓漉祿仂勠朸淕轆錄陸緑碌勒綠
ろっ	六肋緑
ろひこ	州
ろみ	鏡
ろん	論崘乱龍亂崙
わ	禾我杷和娃倭琶話窪輪鷲蛙哇啝夥萵丸久大匂分弁羽花吾沢別波沸房華速破訪渦割湧葉禍詫慧盤環劃詑涌辧夬洶滕澤鐶
わい	哩隈賄蛙歪淮猥薈哀愛慧涌匯矮
わお	乢
わか	稚幼判別若訣解頒嫩觧
わかし	沸
わかじに	殀
わかれ	訣
わが	我吾綰
わき	脇湧刀傍腋
わきぎ	輒輙
わきの	脇
わきばさ	挟
わきま	弁辧
わぎ	吾脇
わく	或画枠湧惑稚劃涌瓠蠖沖飽獲穫濆
わけ	脇訳譯分
わげ	鬟
わこ	若
わさ	沢稙
わざ	伎技業態
わざおぎ	伶妓伎倡
わざわ	災妖禍
わざわい	殃
わし	鷲私儂雕
わしの	鷺
わす	忘
わず	僅
わずか	僅纔
わずかに	才
わずら	患煩擾
わせ	鷲
わた	綿棉亙亘乱杭弥原航済渉渡幡絖緜
わたくし	私
わたし	私済渡
わたな	渡
わたなべ	競
わたの	渡
わたら	度渡
わたり	渡
わたる	亘弥済超
わだ	皮
わだこ	和
わだち	轍
わち	斡
わちが	輪
わっ	和割輪
わっか	稚
わつ	斡
わな	罠羂
わに	鰐丸
わの	倭
わび	詫侘
わめ	喚
わら	藁穣春原笑稿穰听哂嗤稈稾
わらじ	鞋
わらの	原
わらび	蕨
わらべ	竣童僮
わらわ	竣妾
わり	割破張
わりふ	質劵
わる	悪兇惡慝
わるがしこ	猾黠
われ	我吾台俺朕
わん	椀湾腕碗灣綰蜿鋺王雲彎弯
を	乎
